Rk,Player,Pos,Age,Tm,G,GS,MP,FG,FGA,FG%,3P,3PA,3P%,2P,2PA,2P%,eFG%,FT,FTA,FT%,ORB,DRB,TRB,AST,STL,BLK,TOV,PF,PTS
1,Steven Adams\adamsst01,C,26,OKC,51,51,1382,233,400,.583,1,3,.333,232,397,.584,.584,97,160,.606,173,313,486,128,40,58,76,100,564
2,Bam Adebayo\adebaba01,PF,22,MIA,56,56,1927,350,606,.578,1,12,.083,349,594,.588,.578,197,288,.684,146,438,584,282,71,66,154,136,898
3,LaMarcus Aldridge\aldrila01,C,34,SAS,52,52,1717,381,770,.495,60,153,.392,321,617,.520,.534,155,187,.829,103,287,390,127,33,83,73,127,977
4,Nickeil Alexander-Walker\alexani01,SG,21,NOP,41,0,501,77,227,.339,40,117,.342,37,110,.336,.427,17,28,.607,8,72,80,74,11,7,40,46,211
5,Grayson Allen\allengr01,SG,24,MEM,30,0,498,79,176,.449,33,91,.363,46,85,.541,.543,30,35,.857,5,61,66,43,6,1,23,36,221
6,Jarrett Allen\allenja01,C,21,BRK,55,51,1447,233,366,.637,0,5,.000,233,361,.645,.637,132,209,.632,168,358,526,77,33,79,62,129,598
7,Kadeem Allen\allenka01,SG,27,NYK,10,0,117,19,44,.432,5,16,.313,14,28,.500,.489,7,11,.636,2,7,9,21,5,2,8,7,50
8,Al-Farouq Aminu\aminual01,PF,29,ORL,18,2,380,25,86,.291,9,36,.250,16,50,.320,.343,19,29,.655,24,63,87,21,18,8,17,27,78
9,Justin Anderson\anderju01,SF,26,BRK,3,0,17,1,6,.167,0,3,.000,1,3,.333,.167,1,2,.500,0,2,2,0,0,1,0,2,3
10,Kyle Anderson\anderky01,PF,26,MEM,50,11,913,113,224,.504,10,45,.222,103,179,.575,.527,38,58,.655,48,162,210,108,39,24,45,75,274
11,Ryan Anderson\anderry01,PF,31,HOU,2,0,14,2,7,.286,1,5,.200,1,2,.500,.357,0,0,,0,7,7,2,1,0,1,1,5
12,Giannis Antetokounmpo\antetgi01,PF,25,MIL,50,50,1543,554,1003,.552,75,241,.311,479,762,.629,.590,319,519,.615,120,559,679,292,55,53,182,155,1502
13,Kostas Antetokounmpo\antetko01,PF,22,LAL,3,0,5,0,0,,0,0,,0,0,,,0,0,,0,1,1,1,0,0,0,0,0
14,Thanasis Antetokounmpo\antetth01,SF,27,MIL,15,1,61,13,23,.565,0,3,.000,13,20,.650,.565,4,9,.444,6,1,7,6,2,1,5,9,30
15,Carmelo Anthony\anthoca01,PF,35,POR,42,42,1369,247,589,.419,62,172,.360,185,417,.444,.472,98,116,.845,54,220,274,62,34,20,72,124,654
16,OG Anunoby\anunoog01,SF,22,TOR,56,55,1640,229,459,.499,68,187,.364,161,272,.592,.573,46,69,.667,61,239,300,86,66,40,71,132,572
17,Ryan Arcidiacono\arcidry01,PG,25,CHI,54,3,849,80,202,.396,50,130,.385,30,72,.417,.520,25,34,.735,17,82,99,88,23,3,35,87,235
18,Trevor Ariza\arizatr01,SF,34,TOT,45,13,1209,111,257,.432,59,164,.360,52,93,.559,.547,37,45,.822,29,179,208,71,58,12,45,93,318
18,Trevor Ariza\arizatr01,SF,34,SAC,32,0,791,64,165,.388,43,122,.352,21,43,.488,.518,21,27,.778,21,125,146,50,35,7,28,63,192
18,Trevor Ariza\arizatr01,SF,34,POR,13,13,418,47,92,.511,16,42,.381,31,50,.620,.598,16,18,.889,8,54,62,21,23,5,17,30,126
19,D.J. Augustin\augusdj01,PG,32,ORL,40,6,1029,128,328,.390,47,138,.341,81,190,.426,.462,114,130,.877,15,81,96,184,28,1,55,45,417
20,Deandre Ayton\aytonde01,C,21,PHO,25,20,831,213,392,.543,0,2,.000,213,390,.546,.543,50,64,.781,106,199,305,51,18,41,53,79,476
21,Dwayne Bacon\bacondw01,SG,24,CHO,39,11,687,85,244,.348,19,67,.284,66,177,.373,.387,35,53,.660,15,85,100,52,23,2,37,52,224
22,Marvin Bagley\baglema01,PF,20,SAC,13,6,334,78,167,.467,4,22,.182,74,145,.510,.479,25,31,.806,29,68,97,10,6,12,18,43,185
23,Lonzo Ball\balllo01,PG,22,NOP,49,40,1570,216,540,.400,114,311,.367,102,229,.445,.506,30,53,.566,54,241,295,333,65,24,145,96,576
24,Mo Bamba\bambamo01,C,21,ORL,51,0,758,112,240,.467,29,87,.333,83,153,.542,.527,22,32,.688,75,175,250,35,20,72,39,97,275
25,J.J. Barea\bareajo01,PG,35,DAL,18,4,282,62,139,.446,23,54,.426,39,85,.459,.529,14,14,1.000,9,31,40,68,3,2,25,12,161
26,Harrison Barnes\barneha02,PF,27,SAC,56,56,1947,286,627,.456,81,214,.379,205,413,.496,.521,175,218,.803,52,217,269,127,33,9,68,71,828
27,RJ Barrett\barrerj01,SG,19,NYK,46,45,1399,229,589,.389,48,156,.308,181,433,.418,.430,125,206,.607,45,188,233,111,44,16,97,104,631
28,Will Barton\bartowi01,SF,29,DEN,50,50,1656,284,638,.445,90,237,.380,194,401,.484,.516,90,119,.756,73,251,324,190,53,26,71,106,748
29,Keita Bates-Diop\bateske01,SF,24,TOT,39,0,665,89,208,.428,31,94,.330,58,114,.509,.502,49,69,.710,21,91,112,30,17,21,14,38,258
29,Keita Bates-Diop\bateske01,SF,24,MIN,37,0,646,87,206,.422,31,94,.330,56,112,.500,.498,46,65,.708,21,89,110,30,17,20,14,36,251
29,Keita Bates-Diop\bateske01,SF,24,DEN,2,0,19,2,2,1.000,0,0,,2,2,1.000,1.000,3,4,.750,0,2,2,0,0,1,0,2,7
30,Nicolas Batum\batumni01,SF,31,CHO,22,3,505,28,81,.346,14,49,.286,14,32,.438,.432,9,10,.900,25,75,100,66,17,8,22,41,79
31,Aron Baynes\baynear01,C,33,PHO,35,25,780,150,304,.493,43,129,.333,107,175,.611,.564,44,61,.721,54,137,191,63,8,20,41,124,387
32,Kent Bazemore\bazemke01,SF-SG,30,TOT,56,21,1386,157,431,.364,70,207,.338,87,224,.388,.445,91,116,.784,21,205,226,73,61,36,72,156,475
32,Kent Bazemore\bazemke01,SF,30,POR,43,21,1111,113,326,.347,56,171,.327,57,155,.368,.433,58,72,.806,13,159,172,61,45,31,60,121,340
32,Kent Bazemore\bazemke01,SG,30,SAC,13,0,275,44,105,.419,14,36,.389,30,69,.435,.486,33,44,.750,8,46,54,12,16,5,12,35,135
33,Darius Bazley\bazleda01,PF,19,OKC,53,8,909,88,230,.383,30,100,.300,58,130,.446,.448,32,47,.681,21,175,196,29,20,35,40,45,238
34,Bradley Beal\bealbr01,SG,26,WAS,48,48,1709,483,1066,.453,123,384,.320,360,682,.528,.511,330,391,.844,47,164,211,290,53,19,161,108,1419
35,Malik Beasley\beaslma01,SG,23,TOT,46,5,914,157,388,.405,78,207,.377,79,181,.436,.505,43,50,.860,15,94,109,59,34,8,46,63,435
35,Malik Beasley\beaslma01,SG,23,DEN,41,0,746,117,301,.389,58,161,.360,59,140,.421,.485,33,38,.868,9,68,77,48,31,6,36,50,325
35,Malik Beasley\beaslma01,SG,23,MIN,5,5,168,40,87,.460,20,46,.435,20,41,.488,.575,10,12,.833,6,26,32,11,3,2,10,13,110
36,Marco Belinelli\belinma01,SG,33,SAS,48,0,725,94,250,.376,49,140,.350,45,110,.409,.474,32,41,.780,3,75,78,62,9,0,14,38,269
37,Jordan Bell\belljo01,C,25,MIN,27,0,235,32,60,.533,2,9,.222,30,51,.588,.550,17,29,.586,28,50,78,14,2,10,18,17,83
38,DeAndre' Bembry\bembrde01,SG,25,ATL,43,4,915,104,228,.456,15,65,.231,89,163,.546,.489,26,48,.542,34,118,152,81,55,19,60,84,249
39,Dragan Bender\bendedr01,SF,22,TOT,8,0,111,12,29,.414,6,14,.429,6,15,.400,.517,2,5,.400,2,23,25,12,0,6,5,16,32
39,Dragan Bender\bendedr01,SF,22,MIL,7,0,91,10,21,.476,4,9,.444,6,12,.500,.571,2,3,.667,0,20,20,9,0,5,5,16,26
39,Dragan Bender\bendedr01,SF,22,GSW,1,0,20,2,8,.250,2,5,.400,0,3,.000,.375,0,2,.000,2,3,5,3,0,1,0,0,6
40,Dāvis Bertāns\bertada01,PF,27,WAS,46,4,1354,222,510,.435,163,386,.422,59,124,.476,.595,85,98,.867,33,182,215,82,33,30,48,116,692
41,Patrick Beverley\beverpa01,PG,31,LAC,40,40,1121,125,291,.430,64,176,.364,61,115,.530,.540,24,38,.632,51,180,231,159,49,25,54,127,338
42,Khem Birch\birchkh01,C,27,ORL,38,24,773,56,113,.496,0,1,.000,56,112,.500,.496,41,67,.612,70,110,180,35,16,21,23,73,153
43,Goga Bitadze\bitadgo01,C,20,IND,43,2,371,54,112,.482,4,26,.154,50,86,.581,.500,20,29,.690,22,66,88,20,4,29,21,50,132
44,Bismack Biyombo\biyombi01,C,27,CHO,47,26,890,133,246,.541,0,0,,133,246,.541,.541,80,133,.602,109,161,270,41,9,39,43,99,346
45,Nemanja Bjelica\bjeline01,PF,31,SAC,56,53,1593,258,534,.483,115,257,.447,143,277,.516,.591,52,63,.825,94,263,357,157,49,32,81,172,683
46,Eric Bledsoe\bledser01,PG,30,MIL,48,48,1300,278,577,.482,60,175,.343,218,402,.542,.534,136,164,.829,35,192,227,260,45,23,115,102,752
47,Bogdan Bogdanović\bogdabo01,SG,27,SAC,45,12,1271,236,549,.430,116,320,.363,120,229,.524,.536,61,86,.709,16,126,142,139,42,11,79,94,649
48,Bojan Bogdanović\bogdabo02,SF,30,UTA,55,55,1831,373,831,.449,172,408,.422,201,423,.475,.552,221,246,.898,33,197,230,113,31,6,140,96,1139
49,Jonah Bolden\boldejo01,PF,24,TOT,7,0,47,4,11,.364,0,4,.000,4,7,.571,.364,2,4,.500,3,6,9,0,3,2,2,10,10
49,Jonah Bolden\boldejo01,PF,24,PHI,4,0,14,2,3,.667,0,1,.000,2,2,1.000,.667,0,2,.000,0,1,1,0,1,0,2,4,4
49,Jonah Bolden\boldejo01,PF,24,PHO,3,0,33,2,8,.250,0,3,.000,2,5,.400,.250,2,2,1.000,3,5,8,0,2,2,0,6,6
50,Marques Bolden\boldema01,C,21,CLE,1,0,3,0,0,,0,0,,0,0,,,0,0,,0,2,2,0,1,0,0,1,0
51,Jordan Bone\bonejo01,PG,22,DET,10,0,53,5,20,.250,2,10,.200,3,10,.300,.300,0,0,,0,4,4,8,1,0,2,6,12
52,Isaac Bonga\bongais01,SF,20,WAS,50,35,885,87,163,.534,18,45,.400,69,118,.585,.589,46,58,.793,53,107,160,54,33,18,35,116,238
53,Devin Booker\bookede01,SG,23,PHO,54,54,1938,480,972,.494,107,297,.360,373,675,.553,.549,357,387,.922,26,202,228,342,40,13,208,158,1424
54,Chris Boucher\bouchch01,PF,27,TOR,49,0,638,106,230,.461,23,84,.274,83,146,.568,.511,73,93,.785,83,132,215,22,18,49,20,92,308
55,Brian Bowen\bowenbr02,SG,21,IND,3,0,10,1,4,.250,0,1,.000,1,3,.333,.250,0,0,,0,1,1,0,0,1,0,0,2
56,Ky Bowman\bowmaky01,PG,22,GSW,42,12,935,120,296,.405,31,101,.307,89,195,.456,.458,32,39,.821,24,86,110,126,41,9,60,90,303
57,Avery Bradley\bradlav01,SG,29,LAL,41,36,969,143,310,.461,47,126,.373,96,184,.522,.537,16,20,.800,17,77,94,47,35,4,38,95,349
58,Tony Bradley\bradlto01,C,22,UTA,42,2,430,80,125,.640,0,0,,80,125,.640,.640,21,34,.618,72,105,177,11,10,17,22,85,181
59,Jarrell Brantley\brantja01,PF,23,UTA,3,0,11,0,0,,0,0,,0,0,,,0,0,,0,5,5,1,0,2,1,1,0
60,Ignas Brazdeikis\brazdig01,SF,21,NYK,9,0,53,6,22,.273,1,9,.111,5,13,.385,.295,4,5,.800,2,3,5,4,0,1,2,3,17
61,Mikal Bridges\bridgmi01,SF,23,PHO,57,16,1466,170,338,.503,41,124,.331,129,214,.603,.564,79,95,.832,49,174,223,93,86,32,55,127,460
62,Miles Bridges\bridgmi02,SF,21,CHO,56,55,1725,281,642,.438,88,258,.341,193,384,.503,.506,89,111,.802,78,234,312,98,36,40,84,118,739
63,Oshae Brissett\brissos01,SF,21,TOR,19,0,135,13,36,.361,3,15,.200,10,21,.476,.403,8,10,.800,9,17,26,7,4,1,7,18,37
64,Ryan Broekhoff\broekry01,SG,29,DAL,17,1,180,22,59,.373,20,51,.392,2,8,.250,.542,7,8,.875,5,38,43,11,5,4,6,15,71
65,Malcolm Brogdon\brogdma01,PG,27,IND,43,43,1327,257,597,.430,56,182,.308,201,415,.484,.477,130,145,.897,38,167,205,311,30,8,106,79,700
66,Dillon Brooks\brookdi01,SG,24,MEM,56,56,1585,315,774,.407,112,298,.376,203,476,.426,.479,122,150,.813,54,135,189,113,52,23,92,213,864
67,Bruce Brown\brownbr01,SG,23,DET,56,42,1572,189,427,.443,31,92,.337,158,335,.472,.479,87,118,.737,58,207,265,217,63,29,97,157,496
68,Charlie Brown\brownch02,SG,22,ATL,10,0,40,6,19,.316,3,9,.333,3,10,.300,.395,5,5,1.000,2,2,4,2,2,2,3,3,20
69,Jaylen Brown\brownja02,SF,23,BOS,46,46,1552,346,698,.496,96,253,.379,250,445,.562,.564,146,198,.737,50,245,295,99,53,14,111,140,934
70,Moses Brown\brownmo01,C,20,POR,9,0,33,4,10,.400,0,0,,4,10,.400,.400,3,8,.375,3,11,14,1,1,1,3,7,11
71,Sterling Brown\brownst02,SF,24,MIL,39,0,565,70,185,.378,31,95,.326,39,90,.433,.462,26,33,.788,26,121,147,37,21,6,32,41,197
72,Troy Brown\browntr01,SG,20,WAS,52,14,1333,206,446,.462,41,122,.336,165,324,.509,.508,76,101,.752,58,229,287,121,71,5,55,97,529
73,Jalen Brunson\brunsja01,PG,23,DAL,57,16,1022,181,388,.466,43,120,.358,138,268,.515,.522,61,75,.813,22,112,134,188,22,4,66,74,466
74,Thomas Bryant\bryanth01,C,22,WAS,31,23,769,157,266,.590,15,44,.341,142,222,.640,.618,56,77,.727,65,160,225,64,11,28,41,70,385
75,Reggie Bullock\bullore01,SG,28,NYK,22,19,563,82,204,.402,35,102,.343,47,102,.461,.488,16,19,.842,13,43,56,32,24,0,14,50,215
76,Trey Burke\burketr01,PG,27,PHI,25,0,329,59,127,.465,16,38,.421,43,89,.483,.528,13,18,.722,15,20,35,53,7,1,12,21,147
77,Alec Burks\burksal01,SG,28,TOT,51,18,1455,254,629,.404,87,235,.370,167,394,.424,.473,207,231,.896,39,195,234,155,52,17,77,112,802
77,Alec Burks\burksal01,SG,28,GSW,48,18,1390,244,601,.406,84,224,.375,160,377,.424,.476,201,224,.897,37,189,226,151,50,17,76,107,773
77,Alec Burks\burksal01,SG,28,PHI,3,0,65,10,28,.357,3,11,.273,7,17,.412,.411,6,7,.857,2,6,8,4,2,0,1,5,29
78,Deonte Burton\burtode02,SG,26,OKC,31,0,258,35,95,.368,8,40,.200,27,55,.491,.411,6,12,.500,5,35,40,11,4,10,10,27,84
79,Jimmy Butler\butleji01,SF,30,MIA,47,47,1616,290,640,.453,28,114,.246,262,526,.498,.475,358,428,.836,87,236,323,290,84,26,107,66,966
80,Bruno Caboclo\cabocbr01,SF,24,TOT,23,0,197,28,70,.400,4,26,.154,24,44,.545,.429,2,3,.667,17,28,45,10,12,13,9,24,62
80,Bruno Caboclo\cabocbr01,SF,24,MEM,22,0,192,28,69,.406,4,25,.160,24,44,.545,.435,2,3,.667,17,27,44,10,10,12,7,23,62
80,Bruno Caboclo\cabocbr01,SF,24,HOU,1,0,5,0,1,.000,0,1,.000,0,0,,.000,0,0,,0,1,1,0,2,1,2,1,0
81,Kentavious Caldwell-Pope\caldwke01,SG,26,LAL,55,20,1396,187,400,.468,78,192,.406,109,208,.524,.565,71,88,.807,35,82,117,95,45,11,50,100,523
82,Vlatko Čančar\cancavl01,SF,22,DEN,11,0,38,5,11,.455,1,5,.200,4,6,.667,.500,4,4,1.000,3,5,8,3,1,1,3,6,15
83,Clint Capela\capelca01,C,25,HOU,39,39,1279,244,388,.629,0,0,,244,388,.629,.629,55,104,.529,168,369,537,48,33,72,63,102,543
84,DeMarre Carroll\carrode01,SF,33,TOT,16,0,148,9,29,.310,3,13,.231,6,16,.375,.362,14,22,.636,9,25,34,15,2,2,13,20,35
84,DeMarre Carroll\carrode01,SF,33,SAS,15,0,135,9,29,.310,3,13,.231,6,16,.375,.362,12,20,.600,7,24,31,11,2,2,10,20,33
84,DeMarre Carroll\carrode01,SF,33,HOU,1,0,13,0,0,,0,0,,0,0,,,2,2,1.000,2,1,3,4,0,0,3,0,2
85,Jevon Carter\carteje01,PG,24,PHO,42,2,600,64,156,.410,36,86,.419,28,70,.400,.526,15,18,.833,22,58,80,55,31,11,28,58,179
86,Vince Carter\cartevi01,SF,43,ATL,51,0,763,92,262,.351,51,174,.293,41,88,.466,.448,23,29,.793,14,96,110,44,19,24,30,81,258
87,Wendell Carter\cartewe01,C,20,CHI,37,37,1109,166,309,.537,6,28,.214,160,281,.569,.547,95,129,.736,130,236,366,44,30,33,62,142,433
88,Michael Carter-Williams\cartemi01,SG,28,ORL,33,0,592,74,181,.409,12,49,.245,62,132,.470,.442,50,64,.781,35,77,112,87,35,16,35,56,210
89,Alex Caruso\carusal01,PG,25,LAL,52,0,940,100,235,.426,35,99,.354,65,136,.478,.500,53,67,.791,13,85,98,88,54,14,41,82,288
90,Willie Cauley-Stein\caulewi01,C,26,TOT,50,39,1051,167,291,.574,0,1,.000,167,290,.576,.574,39,63,.619,80,216,296,67,49,58,39,118,373
90,Willie Cauley-Stein\caulewi01,C,26,GSW,41,37,940,144,257,.560,0,0,,144,257,.560,.560,35,57,.614,71,184,255,60,45,50,35,102,323
90,Willie Cauley-Stein\caulewi01,C,26,DAL,9,2,111,23,34,.676,0,1,.000,23,33,.697,.676,4,6,.667,9,32,41,7,4,8,4,16,50
91,Tyson Chandler\chandty01,C,37,HOU,26,5,219,14,18,.778,0,0,,14,18,.778,.778,6,13,.462,25,41,66,6,6,8,8,32,34
92,Wilson Chandler\chandwi01,SF,32,BRK,27,0,572,61,145,.421,28,91,.308,33,54,.611,.517,18,21,.857,9,111,120,31,16,10,27,60,168
93,Joe Chealey\chealjo01,PG,24,CHO,1,0,3,0,1,.000,0,1,.000,0,0,,.000,0,0,,0,0,0,0,0,0,0,0,0
94,Zylan Cheatham\cheatzy01,SF,24,NOP,3,0,31,2,5,.400,0,1,.000,2,4,.500,.400,0,0,,1,5,6,2,0,1,3,5,4
95,Chris Chiozza\chiozch01,PG,24,TOT,15,0,150,13,44,.295,8,22,.364,5,22,.227,.386,0,0,,1,18,19,35,12,2,10,12,34
95,Chris Chiozza\chiozch01,PG,24,WAS,10,0,123,10,34,.294,7,16,.438,3,18,.167,.397,0,0,,0,15,15,28,10,2,9,12,27
95,Chris Chiozza\chiozch01,PG,24,BRK,5,0,27,3,10,.300,1,6,.167,2,4,.500,.350,0,0,,1,3,4,7,2,0,1,0,7
96,Marquese Chriss\chrisma01,PF,22,GSW,51,13,977,169,316,.535,8,35,.229,161,281,.573,.547,98,129,.760,95,194,289,87,32,54,66,99,444
97,Gary Clark\clarkga01,PF,25,TOT,31,0,378,36,95,.379,27,82,.329,9,13,.692,.521,8,9,.889,25,51,76,13,4,13,4,29,107
97,Gary Clark\clarkga01,PF,25,HOU,18,0,212,23,59,.390,18,51,.353,5,8,.625,.542,6,7,.857,11,29,40,12,2,7,2,21,70
97,Gary Clark\clarkga01,PF,25,ORL,13,0,166,13,36,.361,9,31,.290,4,5,.800,.486,2,2,1.000,14,22,36,1,2,6,2,8,37
98,Brandon Clarke\clarkbr01,PF,23,MEM,49,2,1083,254,408,.623,21,52,.404,233,356,.654,.648,73,93,.785,77,214,291,72,26,42,45,82,602
99,Jordan Clarkson\clarkjo01,SG,27,TOT,55,0,1338,309,662,.467,119,316,.377,190,346,.549,.557,112,133,.842,37,107,144,115,34,15,68,76,849
99,Jordan Clarkson\clarkjo01,SG,27,CLE,29,0,666,144,326,.442,59,159,.371,85,167,.509,.532,76,86,.884,21,48,69,70,17,8,39,33,423
99,Jordan Clarkson\clarkjo01,SG,27,UTA,26,0,672,165,336,.491,60,157,.382,105,179,.587,.580,36,47,.766,16,59,75,45,17,7,29,43,426
100,Nicolas Claxton\claxtni01,PF,20,BRK,14,0,183,26,46,.565,1,7,.143,25,39,.641,.576,9,19,.474,19,24,43,16,1,8,9,14,62
101,Chris Clemons\clemoch01,SG,22,HOU,28,0,246,50,124,.403,33,93,.355,17,31,.548,.536,6,7,.857,3,20,23,21,6,5,17,20,139
102,Antonius Cleveland\clevean01,SG,25,DAL,6,0,22,2,6,.333,0,1,.000,2,5,.400,.333,1,2,.500,0,3,3,0,1,1,1,2,5
103,Amir Coffey\coffeam01,SG,22,LAC,7,0,67,9,20,.450,1,5,.200,8,15,.533,.475,1,3,.333,2,8,10,4,1,1,2,6,20
104,John Collins\collijo01,PF,22,ATL,32,32,1035,269,466,.577,41,110,.373,228,356,.640,.621,87,108,.806,85,245,330,44,22,54,55,115,666
105,Zach Collins\colliza01,PF,22,POR,3,3,86,9,19,.474,3,7,.429,6,12,.500,.553,6,6,1.000,4,8,12,6,0,2,6,11,27
106,Mike Conley\conlemi01,PG,32,UTA,33,27,927,154,395,.390,58,164,.354,96,231,.416,.463,80,102,.784,20,90,110,140,22,4,60,73,446
107,Pat Connaughton\connapa01,SG,27,MIL,52,0,948,100,221,.452,36,113,.319,64,108,.593,.534,18,25,.720,46,179,225,83,15,28,40,49,254
108,Quinn Cook\cookqu01,PG,26,LAL,34,0,387,71,160,.444,23,60,.383,48,100,.480,.516,6,9,.667,7,32,39,38,10,1,23,20,171
109,Tyler Cook\cookty01,PF,22,CLE,11,0,35,7,10,.700,0,0,,7,10,.700,.700,5,6,.833,4,6,10,1,1,0,1,4,19
110,Robert Covington\covinro01,PF,29,TOT,54,52,1602,243,565,.430,126,366,.344,117,199,.588,.542,80,100,.800,44,285,329,66,87,59,79,169,692
110,Robert Covington\covinro01,PF,29,MIN,48,47,1411,216,496,.435,108,312,.346,108,184,.587,.544,75,94,.798,36,251,287,56,80,45,73,148,615
110,Robert Covington\covinro01,PF,29,HOU,6,5,191,27,69,.391,18,54,.333,9,15,.600,.522,5,6,.833,8,34,42,10,7,14,6,21,77
111,Allen Crabbe\crabbal01,SG,27,TOT,37,1,653,63,177,.356,36,119,.303,27,58,.466,.458,10,14,.714,11,66,77,33,15,4,17,47,172
111,Allen Crabbe\crabbal01,SG,27,ATL,28,1,522,52,143,.364,30,93,.323,22,50,.440,.469,9,12,.750,10,55,65,28,15,4,12,36,143
111,Allen Crabbe\crabbal01,SG,27,MIN,9,0,131,11,34,.324,6,26,.231,5,8,.625,.412,1,2,.500,1,11,12,5,0,0,5,11,29
112,Torrey Craig\craigto01,SF,29,DEN,44,19,785,81,180,.450,30,94,.319,51,86,.593,.533,20,31,.645,44,101,145,30,15,29,20,100,212
113,Jae Crowder\crowdja01,SF,29,TOT,50,46,1463,172,444,.387,95,297,.320,77,147,.524,.494,89,110,.809,45,262,307,132,58,17,57,103,528
113,Jae Crowder\crowdja01,SF,29,MEM,45,45,1322,147,399,.368,78,266,.293,69,133,.519,.466,75,95,.789,40,237,277,125,47,14,54,85,447
113,Jae Crowder\crowdja01,SF,29,MIA,5,1,141,25,45,.556,17,31,.548,8,14,.571,.744,14,15,.933,5,25,30,7,11,3,3,18,81
114,Jarrett Culver\culveja01,SG,20,MIN,54,35,1315,193,495,.390,55,195,.282,138,300,.460,.445,47,103,.456,60,122,182,100,52,36,73,104,488
115,Seth Curry\curryse01,SG,29,DAL,53,15,1269,219,460,.476,111,259,.429,108,201,.537,.597,67,75,.893,25,102,127,105,32,8,52,86,616
116,Stephen Curry\curryst01,PG,31,GSW,4,4,112,27,66,.409,9,37,.243,18,29,.621,.477,18,18,1.000,4,16,20,26,5,2,15,10,81
117,Troy Daniels\danietr01,SG,28,LAL,39,0,446,60,153,.392,39,108,.361,21,45,.467,.520,10,15,.667,12,32,44,14,8,3,9,30,169
118,Anthony Davis\davisan02,PF,26,LAL,48,48,1665,446,867,.514,54,164,.329,392,703,.558,.546,339,402,.843,106,345,451,158,73,118,121,117,1285
119,Ed Davis\davised01,C,30,UTA,25,0,268,14,34,.412,0,0,,14,34,.412,.412,5,11,.455,29,66,95,8,10,9,13,55,33
120,Terence Davis\daviste02,SG,22,TOR,57,2,1003,171,358,.478,85,202,.421,86,156,.551,.596,37,42,.881,45,155,200,97,31,12,58,93,464
121,Dewayne Dedmon\dedmode01,C,30,TOT,39,13,664,85,208,.409,18,87,.207,67,121,.554,.452,26,31,.839,48,160,208,19,18,38,52,115,214
121,Dewayne Dedmon\dedmode01,C,30,SAC,34,10,541,69,171,.404,14,71,.197,55,100,.550,.444,23,28,.821,46,121,167,15,15,26,47,93,175
121,Dewayne Dedmon\dedmode01,C,30,ATL,5,3,123,16,37,.432,4,16,.250,12,21,.571,.486,3,3,1.000,2,39,41,4,3,12,5,22,39
122,Matthew Dellavedova\dellama01,PG,29,CLE,48,0,581,42,130,.323,11,69,.159,31,61,.508,.365,25,28,.893,12,42,54,123,15,1,43,62,120
123,DeMar DeRozan\derozde01,SF,30,SAS,54,54,1842,457,863,.530,8,29,.276,449,834,.538,.534,303,359,.844,34,270,304,280,55,13,133,147,1225
124,Cheick Diallo\diallch01,C,23,PHO,39,2,421,81,122,.664,1,2,.500,80,120,.667,.668,30,35,.857,24,89,113,20,10,11,26,51,193
125,Hamidou Diallo\diallha01,SF,21,OKC,33,2,621,90,198,.455,5,30,.167,85,168,.506,.467,26,40,.650,25,84,109,21,26,6,33,70,211
126,Gorgui Dieng\dienggo01,C,30,TOT,49,17,825,133,291,.457,48,125,.384,85,166,.512,.540,48,60,.800,74,197,271,61,42,43,46,99,362
126,Gorgui Dieng\dienggo01,C,30,MIN,46,17,778,124,277,.448,46,120,.383,78,157,.497,.531,47,59,.797,73,183,256,58,37,42,44,89,341
126,Gorgui Dieng\dienggo01,C,30,MEM,3,0,47,9,14,.643,2,5,.400,7,9,.778,.714,1,1,1.000,1,14,15,3,5,1,2,10,21
127,Spencer Dinwiddie\dinwisp01,SG,26,BRK,55,40,1719,373,900,.414,104,342,.304,269,558,.482,.472,293,379,.773,28,167,195,366,35,18,147,155,1143
128,Donte DiVincenzo\divindo01,SG,23,MIL,51,20,1162,177,389,.455,64,187,.342,113,202,.559,.537,47,61,.770,50,187,237,109,73,15,61,82,465
129,Luka Dončić\doncilu01,PG,20,DAL,45,45,1477,428,919,.466,133,407,.327,295,512,.576,.538,315,412,.765,62,368,430,389,46,8,189,108,1304
130,Luguentz Dort\dortlu01,SG,20,OKC,22,14,462,51,117,.436,18,56,.321,33,61,.541,.513,21,28,.750,12,21,33,16,21,1,13,59,141
131,Damyean Dotson\dotsoda01,SG,25,NYK,46,0,805,115,275,.418,56,155,.361,59,120,.492,.520,22,32,.688,8,76,84,56,22,4,20,42,308
132,Sekou Doumbouya\doumbse01,SF,19,DET,31,19,629,79,200,.395,26,86,.302,53,114,.465,.460,27,40,.675,16,89,105,14,18,7,32,67,211
133,PJ Dozier\doziepj01,PG,23,DEN,16,0,224,34,84,.405,7,26,.269,27,58,.466,.446,7,11,.636,5,25,30,26,7,5,11,27,82
134,Goran Dragić\dragigo01,PG,33,MIA,45,1,1270,245,546,.449,101,260,.388,144,286,.503,.541,135,177,.763,20,115,135,224,27,8,115,83,726
135,Andre Drummond\drumman01,C,26,TOT,53,52,1752,382,720,.531,3,26,.115,379,694,.546,.533,154,267,.577,242,580,822,145,102,87,194,185,921
135,Andre Drummond\drumman01,C,26,DET,49,48,1654,360,679,.530,1,21,.048,359,658,.546,.531,149,255,.584,226,549,775,138,97,82,174,176,870
135,Andre Drummond\drumman01,C,26,CLE,4,4,98,22,41,.537,2,5,.400,20,36,.556,.561,5,12,.417,16,31,47,7,5,5,20,9,51
136,Jared Dudley\dudleja01,SF,34,LAL,37,1,300,20,48,.417,16,33,.485,4,15,.267,.583,2,2,1.000,5,35,40,18,11,3,6,36,58
137,Kris Dunn\dunnkr01,PG,25,CHI,51,32,1269,152,342,.444,29,112,.259,123,230,.535,.487,40,54,.741,23,163,186,173,101,17,68,158,373
138,Carsen Edwards\edwarca01,SG,21,BOS,33,0,296,33,103,.320,19,62,.306,14,41,.341,.413,11,13,.846,5,36,41,22,10,3,15,27,96
139,Henry Ellenson\ellenhe01,PF,23,BRK,5,0,15,1,7,.143,0,4,.000,1,3,.333,.143,0,0,,2,4,6,1,0,0,0,1,2
140,Wayne Ellington\ellinwa01,SG,32,NYK,28,1,429,48,134,.358,37,107,.346,11,27,.407,.496,11,13,.846,4,42,46,28,11,2,15,28,144
141,Joel Embiid\embiijo01,C,25,PHI,41,41,1258,305,660,.462,53,155,.342,252,505,.499,.502,286,351,.815,113,379,492,131,34,56,126,144,949
142,James Ennis\ennisja01,SF,29,TOT,52,1,827,105,241,.436,38,112,.339,67,129,.519,.515,52,67,.776,53,106,159,42,23,14,33,88,300
142,James Ennis\ennisja01,SF,29,PHI,49,0,776,100,226,.442,37,106,.349,63,120,.525,.524,48,61,.787,48,102,150,41,23,14,31,85,285
142,James Ennis\ennisja01,SF,29,ORL,3,1,51,5,15,.333,1,6,.167,4,9,.444,.367,4,6,.667,5,4,9,1,0,0,2,3,15
143,Drew Eubanks\eubandr01,PF,22,SAS,8,0,42,10,15,.667,0,0,,10,15,.667,.667,3,3,1.000,6,11,17,2,0,1,5,5,23
144,Jacob Evans\evansja02,SG,22,TOT,28,1,415,45,133,.338,13,38,.342,32,95,.337,.387,25,29,.862,9,32,41,31,11,12,25,41,128
144,Jacob Evans\evansja02,SG,22,GSW,27,1,414,45,133,.338,13,38,.342,32,95,.337,.387,25,29,.862,9,32,41,31,11,12,25,41,128
144,Jacob Evans\evansja02,SG,22,MIN,1,0,1,0,0,,0,0,,0,0,,,0,0,,0,0,0,0,0,0,0,0,0
145,Dante Exum\exumda01,SG,24,TOT,34,1,479,56,118,.475,15,42,.357,41,76,.539,.538,32,43,.744,12,54,66,40,13,6,31,37,159
145,Dante Exum\exumda01,SG,24,UTA,11,0,83,10,23,.435,2,6,.333,8,17,.471,.478,2,2,1.000,3,9,12,7,1,2,10,8,24
145,Dante Exum\exumda01,SG,24,CLE,23,1,396,46,95,.484,13,36,.361,33,59,.559,.553,30,41,.732,9,45,54,33,12,4,21,29,135
146,Tacko Fall\fallta01,C,24,BOS,6,0,24,9,12,.750,0,0,,9,12,.750,.750,1,3,.333,0,11,11,0,0,2,3,5,19
147,Derrick Favors\favorde01,C,28,NOP,38,36,909,161,259,.622,1,6,.167,160,253,.632,.624,32,55,.582,120,260,380,68,21,37,48,85,355
148,Cristiano Felício\feliccr01,PF,27,CHI,18,0,337,30,47,.638,0,2,.000,30,45,.667,.638,18,23,.783,47,41,88,12,9,1,18,31,78
149,Terrance Ferguson\fergute01,SF,21,OKC,43,36,1054,67,176,.381,42,137,.307,25,39,.641,.500,10,13,.769,21,47,68,41,23,13,28,131,186
150,Bruno Fernando\fernabr01,C,21,ATL,47,11,569,81,157,.516,4,31,.129,77,126,.611,.529,26,44,.591,59,100,159,39,15,16,40,91,192
151,Yogi Ferrell\ferreyo01,PG,26,SAC,42,0,467,67,164,.409,19,66,.288,48,98,.490,.466,30,35,.857,6,40,46,57,14,4,23,28,183
152,Dorian Finney-Smith\finnedo01,PF,26,DAL,57,54,1701,188,412,.456,90,241,.373,98,171,.573,.566,62,86,.721,116,204,320,86,39,32,57,133,528
153,Bryn Forbes\forbebr01,SG,26,SAS,56,55,1413,214,521,.411,130,340,.382,84,181,.464,.536,62,75,.827,12,106,118,104,31,0,47,104,620
154,Evan Fournier\fournev01,SG,27,ORL,55,55,1746,365,788,.463,149,365,.408,216,423,.511,.558,157,189,.831,13,133,146,172,60,10,111,137,1036
155,De'Aaron Fox\foxde01,PG,22,SAC,38,36,1202,272,579,.470,39,124,.315,233,455,.512,.503,172,254,.677,26,131,157,264,55,20,126,109,755
156,Melvin Frazier\frazime01,SG,23,ORL,14,0,48,6,17,.353,4,7,.571,2,10,.200,.471,2,4,.500,1,3,4,1,4,2,2,8,18
157,Michael Frazier\frazimi01,SG,25,HOU,8,0,66,4,11,.364,2,8,.250,2,3,.667,.455,4,6,.667,1,2,3,1,2,0,2,13,14
158,Tim Frazier\fraziti01,PG,29,DET,27,11,355,34,94,.362,10,30,.333,24,64,.375,.415,19,24,.792,9,24,33,93,14,4,36,42,97
159,Markelle Fultz\fultzma01,PG,21,ORL,55,50,1548,270,577,.468,27,102,.265,243,475,.512,.491,90,120,.750,25,164,189,277,72,9,112,104,657
160,Wenyen Gabriel\gabriwe01,PF,22,TOT,20,1,145,13,34,.382,2,13,.154,11,21,.524,.412,9,14,.643,11,15,26,4,5,5,8,23,37
160,Wenyen Gabriel\gabriwe01,PF,22,SAC,11,0,61,6,17,.353,1,8,.125,5,9,.556,.382,6,10,.600,4,6,10,3,3,2,5,7,19
160,Wenyen Gabriel\gabriwe01,PF,22,POR,9,1,84,7,17,.412,1,5,.200,6,12,.500,.441,3,4,.750,7,9,16,1,2,3,3,16,18
161,Daniel Gafford\gaffoda01,C,21,CHI,36,6,483,76,111,.685,0,0,,76,111,.685,.685,24,48,.500,43,46,89,16,12,46,23,75,176
162,Danilo Gallinari\gallida01,PF,31,OKC,49,49,1501,289,658,.439,144,355,.406,145,303,.479,.549,213,236,.903,31,243,274,110,33,4,67,63,935
163,Langston Galloway\gallola01,SG,28,DET,59,6,1528,207,476,.435,117,294,.398,90,182,.495,.558,71,82,.866,28,102,130,94,42,10,37,82,602
164,Darius Garland\garlada01,PG,20,CLE,55,55,1685,258,647,.399,100,282,.355,158,365,.433,.476,61,70,.871,24,78,102,213,40,2,144,88,677
165,Marc Gasol\gasolma01,C,35,TOR,35,35,974,98,231,.424,50,124,.403,48,107,.449,.532,26,36,.722,29,197,226,122,28,33,43,101,272
166,Rudy Gay\gayru01,PF,33,SAS,53,5,1105,183,420,.436,49,156,.314,134,264,.508,.494,89,102,.873,48,233,281,90,22,23,69,75,504
167,Paul George\georgpa01,SF,29,LAC,34,34,1001,243,570,.426,111,282,.394,132,288,.458,.524,142,158,.899,15,192,207,133,45,18,102,83,739
168,Taj Gibson\gibsota01,C,34,NYK,53,47,872,138,240,.575,3,11,.273,135,229,.590,.581,30,44,.682,93,134,227,47,23,24,40,108,309
169,Harry Giles\gilesha01,PF,21,SAC,30,9,406,77,141,.546,0,0,,77,141,.546,.546,20,27,.741,26,86,112,38,14,12,28,73,174
170,Shai Gilgeous-Alexander\gilgesh01,SG,21,OKC,57,57,2025,399,860,.464,70,202,.347,329,658,.500,.505,236,291,.811,43,313,356,190,64,37,107,97,1104
171,Rudy Gobert\goberru01,C,27,UTA,54,54,1869,320,465,.688,0,0,,320,465,.688,.688,200,326,.613,195,583,778,81,35,104,107,166,840
172,Brandon Goodwin\goodwbr01,PG,24,ATL,28,1,367,64,167,.383,23,78,.295,41,89,.461,.452,25,26,.962,10,54,64,43,11,4,25,38,176
173,Aaron Gordon\gordoaa01,PF,24,ORL,50,50,1615,265,628,.422,60,198,.303,205,430,.477,.470,114,170,.671,87,284,371,161,40,25,78,101,704
174,Eric Gordon\gordoer01,SG,31,HOU,29,12,847,145,385,.377,84,253,.332,61,132,.462,.486,65,90,.722,7,52,59,44,19,11,30,59,439
175,Devonte' Graham\grahade01,PG,24,CHO,56,46,1961,314,842,.373,190,516,.368,124,326,.380,.486,167,205,.815,41,158,199,429,53,15,163,104,985
176,Treveon Graham\grahatr01,SG,26,TOT,46,20,803,72,207,.348,26,103,.252,46,104,.442,.411,33,47,.702,37,88,125,33,21,5,23,83,203
176,Treveon Graham\grahatr01,SG,26,MIN,33,20,663,62,175,.354,20,83,.241,42,92,.457,.411,27,37,.730,29,71,100,30,17,2,19,66,171
176,Treveon Graham\grahatr01,SG,26,ATL,13,0,140,10,32,.313,6,20,.300,4,12,.333,.406,6,10,.600,8,17,25,3,4,3,4,17,32
177,Jerami Grant\grantje01,PF,25,DEN,56,21,1465,223,480,.465,74,191,.387,149,289,.516,.542,108,147,.735,48,151,199,63,36,48,46,116,628
178,Josh Gray\grayjo01,PG,26,NOP,2,0,23,1,2,.500,0,0,,1,2,.500,.500,0,0,,1,1,2,2,0,0,5,1,2
179,Danny Green\greenda02,SG,32,LAL,54,54,1347,161,384,.419,101,269,.375,60,115,.522,.551,32,44,.727,38,147,185,72,67,27,48,114,455
180,Draymond Green\greendr01,PF,29,GSW,42,42,1212,122,315,.387,36,129,.279,86,186,.462,.444,63,83,.759,23,242,265,262,58,33,95,106,343
181,JaMychal Green\greenja01,PF,29,LAC,47,0,971,103,259,.398,62,175,.354,41,84,.488,.517,31,42,.738,66,231,297,34,22,17,40,124,299
182,Javonte Green\greenja02,SF,26,BOS,41,1,375,48,94,.511,6,23,.261,42,71,.592,.543,23,36,.639,16,53,69,21,22,5,16,36,125
183,Jeff Green\greenje02,PF,33,TOT,32,2,591,82,204,.402,38,110,.345,44,94,.468,.495,50,65,.769,15,73,88,22,13,10,32,49,252
183,Jeff Green\greenje02,PF,33,UTA,30,2,553,75,195,.385,34,104,.327,41,91,.451,.472,49,63,.778,14,67,81,20,12,10,27,46,233
183,Jeff Green\greenje02,PF,33,HOU,2,0,38,7,9,.778,4,6,.667,3,3,1.000,1.000,1,2,.500,1,6,7,2,1,0,5,3,19
184,Blake Griffin\griffbl01,PF,30,DET,18,18,512,88,250,.352,27,111,.243,61,139,.439,.406,76,98,.776,17,67,84,59,7,7,40,27,279
185,Marko Guduric\gudurma01,SG,24,MEM,35,0,444,54,141,.383,21,72,.292,33,69,.478,.457,21,23,.913,12,52,64,41,11,7,34,32,150
186,Kyle Guy\guyky01,SG,22,SAC,2,0,4,1,2,.500,0,1,.000,1,1,1.000,.500,0,0,,0,0,0,0,0,0,0,0,2
187,Rui Hachimura\hachiru01,PF,21,WAS,32,32,923,184,376,.489,14,59,.237,170,317,.536,.508,61,73,.836,49,145,194,53,25,5,31,71,443
188,Devon Hall\hallde01,SG,24,OKC,5,0,20,1,5,.200,0,2,.000,1,3,.333,.200,3,4,.750,0,1,1,3,0,0,1,1,5
189,Tim Hardaway\hardati02,SG,27,DAL,54,41,1492,283,648,.437,152,374,.406,131,274,.478,.554,98,122,.803,21,144,165,108,32,4,51,93,816
190,James Harden\hardeja01,SG,30,HOU,53,53,1958,536,1222,.439,243,677,.359,293,545,.538,.538,552,636,.868,56,285,341,391,88,52,233,180,1867
191,Maurice Harkless\harklma01,SF,26,TOT,52,38,1183,115,225,.511,28,77,.364,87,148,.588,.573,24,42,.571,48,160,208,50,50,30,47,122,282
191,Maurice Harkless\harklma01,SF,26,LAC,50,38,1141,112,217,.516,27,73,.370,85,144,.590,.578,24,42,.571,47,153,200,48,49,30,46,120,275
191,Maurice Harkless\harklma01,SF,26,NYK,2,0,42,3,8,.375,1,4,.250,2,4,.500,.438,0,0,,1,7,8,2,1,0,1,2,7
192,Jared Harper\harpeja01,PG,22,PHO,3,0,8,1,4,.250,0,2,.000,1,2,.500,.250,0,0,,0,0,0,0,0,0,0,0,2
193,Montrezl Harrell\harremo01,C,26,LAC,55,2,1561,421,731,.576,0,16,.000,421,715,.589,.576,190,298,.638,150,242,392,98,37,62,98,129,1032
194,Gary Harris\harriga01,SG,25,DEN,48,47,1537,182,457,.398,58,190,.305,124,267,.464,.462,68,82,.829,22,118,140,101,63,11,50,102,490
195,Joe Harris\harrijo01,SF,28,BRK,54,54,1692,280,597,.469,129,320,.403,151,277,.545,.577,55,73,.753,48,182,230,114,35,14,76,124,744
196,Tobias Harris\harrito02,PF,27,PHI,57,57,1962,422,896,.471,98,276,.355,324,620,.523,.526,137,170,.806,41,346,387,173,41,31,86,129,1079
197,Shaquille Harrison\harrish01,SF,26,CHI,36,4,305,50,112,.446,7,26,.269,43,86,.500,.478,28,37,.757,12,43,55,34,19,9,15,36,135
198,Josh Hart\hartjo01,SF,24,NOP,50,14,1406,182,428,.425,104,290,.359,78,138,.565,.547,63,85,.741,48,282,330,79,52,20,57,133,531
199,Isaiah Hartenstein\harteis01,C,21,HOU,23,2,266,44,67,.657,0,5,.000,44,62,.710,.657,19,28,.679,29,61,90,18,9,12,16,41,107
200,Udonis Haslem\hasleud01,PF,39,MIA,3,0,21,1,6,.167,0,2,.000,1,4,.250,.167,3,4,.750,0,8,8,1,0,0,0,3,5
201,Jaxson Hayes\hayesja02,C,19,NOP,54,12,937,153,231,.662,1,4,.250,152,227,.670,.665,109,173,.630,82,140,222,51,22,52,40,140,416
202,Gordon Hayward\haywago01,SF,29,BOS,39,39,1304,266,526,.506,62,162,.383,204,364,.560,.565,84,97,.866,41,221,262,166,29,17,69,69,678
203,John Henson\hensojo01,PF,29,TOT,34,2,490,76,141,.539,6,32,.188,70,109,.642,.560,20,36,.556,41,97,138,47,19,39,27,62,178
203,John Henson\hensojo01,PF,29,CLE,29,2,412,61,120,.508,6,31,.194,55,89,.618,.533,17,33,.515,32,82,114,43,16,32,21,55,145
203,John Henson\hensojo01,PF,29,DET,5,0,78,15,21,.714,0,1,.000,15,20,.750,.714,3,3,1.000,9,15,24,4,3,7,6,7,33
204,Dewan Hernandez\hernade01,C,23,TOR,4,0,11,1,5,.200,0,1,.000,1,4,.250,.200,2,2,1.000,2,5,7,0,1,0,1,6,4
205,Juan Hernangómez\hernaju01,PF,24,TOT,39,5,565,60,164,.366,26,83,.313,34,81,.420,.445,30,46,.652,34,88,122,26,8,7,21,42,176
205,Juan Hernangómez\hernaju01,PF,24,DEN,34,0,422,38,110,.345,15,60,.250,23,50,.460,.414,16,25,.640,24,71,95,22,5,5,18,29,107
205,Juan Hernangómez\hernaju01,PF,24,MIN,5,5,143,22,54,.407,11,23,.478,11,31,.355,.509,14,21,.667,10,17,27,4,3,2,3,13,69
206,Willy Hernangómez\hernawi01,C,25,CHO,24,0,254,53,101,.525,5,20,.250,48,81,.593,.550,26,46,.565,30,56,86,16,6,5,22,28,137
207,Tyler Herro\herroty01,SG,20,MIA,46,6,1273,219,529,.414,99,252,.393,120,277,.433,.508,66,79,.835,14,172,186,91,29,7,72,58,603
208,Kevin Hervey\herveke01,PF,23,OKC,6,0,13,0,5,.000,0,4,.000,0,1,.000,.000,0,0,,0,2,2,1,0,0,0,1,0
209,Mario Hezonja\hezonma01,PF,24,POR,40,4,645,60,156,.385,15,53,.283,45,103,.437,.433,40,49,.816,23,118,141,31,24,6,29,86,175
210,Buddy Hield\hieldbu01,SG,27,SAC,56,44,1847,408,949,.430,210,545,.385,198,404,.490,.541,103,122,.844,53,222,275,180,50,16,135,137,1129
211,George Hill\hillge01,PG,33,MIL,46,0,969,156,290,.538,67,132,.508,89,158,.563,.653,57,69,.826,41,96,137,136,35,4,42,66,436
212,Solomon Hill\hillso01,SF,28,TOT,50,3,923,98,240,.408,57,151,.377,41,89,.461,.527,26,38,.684,26,121,147,94,33,7,41,75,279
212,Solomon Hill\hillso01,SF,28,MEM,48,3,901,96,233,.412,56,147,.381,40,86,.465,.532,26,38,.684,24,120,144,94,31,7,40,73,274
212,Solomon Hill\hillso01,SF,28,MIA,2,0,22,2,7,.286,1,4,.250,1,3,.333,.357,0,0,,2,1,3,0,2,0,1,2,5
213,Jaylen Hoard\hoardja01,SF,20,POR,13,0,103,15,32,.469,0,3,.000,15,29,.517,.469,8,13,.615,14,18,32,4,5,0,4,12,38
214,Aaron Holiday\holidaa01,PG,23,IND,50,20,1149,186,448,.415,75,184,.408,111,264,.420,.499,50,58,.862,19,93,112,174,36,11,66,90,497
215,Jrue Holiday\holidjr01,SG,29,NOP,48,48,1663,364,818,.445,99,278,.356,265,540,.491,.506,102,144,.708,59,166,225,325,81,41,143,100,929
216,Justin Holiday\holidju01,SG,30,IND,57,2,1447,163,376,.434,106,252,.421,57,124,.460,.574,41,54,.759,29,159,188,83,60,37,32,103,473
217,Rondae Hollis-Jefferson\holliro01,SF,25,TOR,45,3,885,128,266,.481,2,17,.118,126,249,.506,.485,90,123,.732,89,130,219,81,42,18,46,95,348
218,Richaun Holmes\holmeri01,C,26,SAC,37,33,1087,204,309,.660,0,0,,204,309,.660,.660,76,93,.817,113,201,314,37,39,52,46,144,484
219,Rodney Hood\hoodro01,SF,27,POR,21,21,619,87,172,.506,35,71,.493,52,101,.515,.608,21,27,.778,10,62,72,32,17,4,19,46,230
220,Al Horford\horfoal01,C,33,PHI,52,49,1586,247,566,.436,73,228,.320,174,338,.515,.501,43,59,.729,78,267,345,197,45,47,52,112,610
221,Talen Horton-Tucker\hortota01,SG,19,LAL,2,0,5,0,1,.000,0,1,.000,0,0,,.000,0,0,,0,0,0,2,1,0,0,0,0
222,Danuel House\houseda01,SF,26,HOU,50,39,1530,179,422,.424,105,275,.382,74,147,.503,.549,60,76,.789,53,170,223,63,57,27,43,103,523
223,Dwight Howard\howardw01,C,34,LAL,55,2,1080,174,237,.734,3,5,.600,171,232,.737,.741,77,163,.472,146,280,426,35,22,71,67,179,428
224,William Howard\howarwi01,SG,26,HOU,2,0,13,0,4,.000,0,4,.000,0,0,,.000,0,0,,0,2,2,1,0,0,1,1,0
225,Kevin Huerter\huertke01,SG,21,ATL,47,39,1443,209,508,.411,107,279,.384,102,229,.445,.517,47,57,.825,28,166,194,162,41,21,77,111,572
226,De'Andre Hunter\huntede01,SF,22,ATL,54,53,1704,243,588,.413,90,255,.353,153,333,.459,.490,88,116,.759,30,186,216,98,42,15,86,149,664
227,Chandler Hutchison\hutchch01,SF,23,CHI,28,10,527,80,175,.457,12,38,.316,68,137,.496,.491,46,78,.590,18,90,108,26,27,7,27,47,218
228,Serge Ibaka\ibakase01,C,30,TOR,46,23,1246,301,570,.528,58,142,.408,243,428,.568,.579,81,109,.743,96,277,373,61,24,39,91,128,741
229,Andre Iguodala\iguodan01,SG,36,MIA,5,0,105,9,19,.474,4,12,.333,5,7,.714,.579,1,4,.250,8,16,24,8,2,3,5,13,23
230,Ersan İlyasova\ilyaser01,PF,32,MIL,51,7,823,133,282,.472,44,118,.373,89,164,.543,.550,61,73,.836,56,198,254,45,22,14,29,79,371
231,Joe Ingles\inglejo01,SF,32,UTA,56,36,1688,195,451,.432,110,280,.393,85,171,.497,.554,57,73,.781,20,205,225,291,49,7,107,121,557
232,Brandon Ingram\ingrabr01,PF,22,NOP,49,49,1662,411,873,.471,123,306,.402,288,567,.508,.541,257,299,.860,41,267,308,210,47,35,147,140,1202
233,Kyrie Irving\irvinky01,PG,27,BRK,20,20,658,199,416,.478,56,142,.394,143,274,.522,.546,94,102,.922,22,81,103,128,27,10,52,53,548
234,Jonathan Isaac\isaacjo01,SF,22,ORL,32,32,949,149,322,.463,30,91,.330,119,231,.515,.509,56,73,.767,57,165,222,44,50,78,47,79,384
235,Wesley Iwundu\iwundwe01,SF,25,ORL,41,15,749,68,178,.382,20,62,.323,48,116,.414,.438,54,66,.818,22,84,106,44,25,10,17,60,210
236,Frank Jackson\jacksfr01,PG,21,NOP,45,1,583,91,225,.404,33,105,.314,58,120,.483,.478,44,57,.772,15,41,56,37,15,4,39,61,259
237,Jaren Jackson\jacksja02,C,20,MEM,54,54,1512,328,701,.468,135,340,.397,193,361,.535,.564,123,166,.741,53,201,254,76,36,87,94,219,914
238,Josh Jackson\jacksjo02,SG,22,MEM,9,0,164,27,59,.458,6,24,.250,21,35,.600,.508,13,18,.722,6,29,35,10,7,2,13,17,73
239,Justin Jackson\jacksju01,PF,24,DAL,51,2,820,112,282,.397,41,136,.301,71,146,.486,.470,33,40,.825,23,104,127,34,10,6,11,55,298
240,Reggie Jackson\jacksre01,PG,29,TOT,15,11,404,79,207,.382,33,88,.375,46,119,.387,.461,26,33,.788,11,32,43,76,8,1,25,24,217
240,Reggie Jackson\jacksre01,PG,29,DET,14,10,381,76,198,.384,31,82,.378,45,116,.388,.462,26,33,.788,11,30,41,72,8,1,23,21,209
240,Reggie Jackson\jacksre01,PG,29,LAC,1,1,23,3,9,.333,2,6,.333,1,3,.333,.444,0,0,,0,2,2,4,0,0,2,3,8
241,Justin James\jamesju01,SG,23,SAC,32,0,216,33,78,.423,9,26,.346,24,52,.462,.481,10,21,.476,6,24,30,16,6,9,8,16,85
242,LeBron James\jamesle01,PG,35,LAL,53,53,1850,507,1034,.490,114,330,.345,393,704,.558,.545,207,299,.692,51,359,410,567,66,24,209,93,1335
243,Amile Jefferson\jeffeam01,PF,26,ORL,18,0,74,5,14,.357,0,0,,5,14,.357,.357,5,14,.357,10,13,23,4,1,3,3,7,15
244,DaQuan Jeffries\jeffrda01,SG,22,SAC,6,0,19,3,7,.429,1,4,.250,2,3,.667,.500,0,0,,1,0,1,1,1,0,0,3,7
245,Ty Jerome\jeromty01,PG,22,PHO,23,0,268,33,93,.355,11,40,.275,22,53,.415,.414,11,14,.786,6,31,37,39,14,3,18,25,88
246,Alize Johnson\johnsal02,SF,23,IND,12,0,50,7,15,.467,0,0,,7,15,.467,.467,4,6,.667,7,10,17,2,0,0,2,6,18
247,B.J. Johnson\johnsbj01,SF,24,ORL,8,0,46,5,18,.278,1,6,.167,4,12,.333,.306,2,2,1.000,1,5,6,2,2,0,3,0,13
248,Cameron Johnson\johnsca02,PF,23,PHO,44,1,870,117,284,.412,77,197,.391,40,87,.460,.548,32,42,.762,37,87,124,47,26,13,27,62,343
249,James Johnson\johnsja01,PF,32,TOT,23,1,409,56,129,.434,23,63,.365,33,66,.500,.523,17,26,.654,13,65,78,39,15,21,27,52,152
249,James Johnson\johnsja01,PF,32,MIA,18,0,281,39,87,.448,16,45,.356,23,42,.548,.540,8,14,.571,8,44,52,21,6,13,15,34,102
249,James Johnson\johnsja01,PF,32,MIN,5,1,128,17,42,.405,7,18,.389,10,24,.417,.488,9,12,.750,5,21,26,18,9,8,12,18,50
250,Keldon Johnson\johnske04,SF,20,SAS,5,0,25,6,15,.400,0,1,.000,6,14,.429,.400,1,2,.500,2,4,6,3,0,0,1,2,13
251,Stanley Johnson\johnsst04,PF,23,TOR,19,0,95,8,30,.267,2,13,.154,6,17,.353,.300,5,6,.833,3,19,22,8,4,2,8,10,23
252,Tyler Johnson\johnsty01,SG,27,PHO,31,3,515,65,171,.380,24,83,.289,41,88,.466,.450,24,32,.750,10,42,52,50,12,8,24,43,178
253,Nikola Jokić\jokicni01,C,24,DEN,57,57,1854,463,878,.527,69,210,.329,394,668,.590,.567,196,241,.813,136,441,577,391,67,40,170,177,1191
254,Damian Jones\jonesda03,C,24,ATL,51,27,850,118,172,.686,2,8,.250,116,164,.707,.692,62,84,.738,71,123,194,32,26,38,28,139,300
255,Derrick Jones\jonesde02,SF,22,MIA,42,7,1028,131,264,.496,29,104,.279,102,160,.638,.551,76,97,.784,43,132,175,42,44,28,25,93,367
256,Tyus Jones\jonesty01,PG,23,MEM,56,6,1054,165,348,.474,36,91,.396,129,257,.502,.526,32,43,.744,8,81,89,254,47,6,48,36,398
257,DeAndre Jordan\jordade01,C,31,BRK,47,4,1015,160,240,.667,0,0,,160,240,.667,.667,70,100,.700,116,348,464,93,16,46,66,95,390
258,Cory Joseph\josepco01,PG,28,SAC,56,21,1376,137,333,.411,42,121,.347,95,212,.448,.474,40,50,.800,33,114,147,187,38,18,59,106,356
259,Mfiondu Kabengele\kabenmf01,C,22,LAC,12,0,64,14,32,.438,9,20,.450,5,12,.417,.578,5,5,1.000,1,10,11,2,2,2,2,9,42
260,Frank Kaminsky\kaminfr01,C,26,PHO,32,13,718,127,279,.455,39,112,.348,88,167,.527,.525,59,88,.670,30,128,158,71,13,10,33,69,352
261,Enes Kanter\kanteen01,C,27,BOS,44,6,797,164,284,.577,1,7,.143,163,277,.588,.579,56,80,.700,125,229,354,43,17,35,47,79,385
262,Luke Kennard\kennalu01,SG,23,DET,28,25,922,151,342,.442,73,183,.399,78,159,.491,.548,67,75,.893,9,89,98,115,12,6,43,65,442
263,Stanton Kidd\kiddst01,SF,27,UTA,4,0,15,0,3,.000,0,1,.000,0,2,.000,.000,0,0,,0,3,3,1,0,0,2,3,0
264,Michael Kidd-Gilchrist\kiddgmi01,PF-SF,26,TOT,14,0,169,18,54,.333,5,17,.294,13,37,.351,.380,7,9,.778,10,26,36,10,0,3,8,22,48
264,Michael Kidd-Gilchrist\kiddgmi01,PF,26,CHO,12,0,160,18,53,.340,5,17,.294,13,36,.361,.387,7,9,.778,9,26,35,10,0,3,7,18,48
264,Michael Kidd-Gilchrist\kiddgmi01,SF,26,DAL,2,0,9,0,1,.000,0,0,,0,1,.000,.000,0,0,,1,0,1,0,0,0,1,4,0
265,Louis King\kinglo02,SF,20,DET,10,0,62,8,21,.381,4,11,.364,4,10,.400,.476,0,3,.000,1,9,10,5,2,0,2,10,20
266,Maxi Kleber\klebima01,C,28,DAL,56,16,1400,182,390,.467,90,237,.380,92,153,.601,.582,64,71,.901,90,204,294,58,15,64,40,127,518
267,Brandon Knight\knighbr03,PG,28,TOT,19,0,286,33,101,.327,23,78,.295,10,23,.435,.441,8,17,.471,3,20,23,36,6,2,23,25,97
267,Brandon Knight\knighbr03,PG,28,CLE,16,0,241,28,86,.326,19,64,.297,9,22,.409,.436,4,13,.308,3,17,20,31,5,2,16,20,79
267,Brandon Knight\knighbr03,PG,28,DET,3,0,45,5,15,.333,4,14,.286,1,1,1.000,.467,4,4,1.000,0,3,3,5,1,0,7,5,18
268,Kevin Knox\knoxke01,SF,20,NYK,55,4,1005,127,345,.368,57,176,.324,70,169,.414,.451,58,88,.659,20,136,156,53,20,22,37,89,369
269,John Konchar\konchjo01,SG,23,MEM,6,0,34,3,5,.600,0,2,.000,3,3,1.000,.600,1,1,1.000,0,2,2,3,0,0,0,1,7
270,Furkan Korkmaz\korkmfu01,SG,22,PHI,56,12,1194,196,447,.438,108,273,.396,88,174,.506,.559,37,52,.712,16,112,128,53,29,14,39,75,537
271,Luke Kornet\kornelu01,C,24,CHI,36,14,559,82,187,.439,31,108,.287,51,79,.646,.521,20,28,.714,22,62,84,32,11,26,14,54,215
272,Kyle Korver\korveky01,SF,38,MIL,47,0,782,99,237,.418,77,189,.407,22,48,.458,.580,26,31,.839,12,85,97,55,20,11,39,61,301
273,Rodions Kurucs\kurucro01,PF,21,BRK,33,4,427,57,117,.487,25,54,.463,32,63,.508,.594,14,22,.636,16,64,80,29,13,2,32,57,153
274,Kyle Kuzma\kuzmaky01,PF,24,LAL,46,6,1137,214,493,.434,65,202,.322,149,291,.512,.500,84,115,.730,42,159,201,61,16,19,73,86,577
275,Skal Labissière\labissk01,C,23,POR,33,1,567,81,147,.551,3,13,.231,78,134,.582,.561,25,33,.758,65,104,169,42,7,31,30,89,190
276,Jeremy Lamb\lambje01,SG,27,IND,46,42,1291,216,479,.451,53,158,.335,163,321,.508,.506,92,110,.836,24,176,200,96,55,22,50,104,577
277,Romeo Langford\langfro01,SG,20,BOS,20,1,219,21,47,.447,5,18,.278,16,29,.552,.500,14,21,.667,6,13,19,3,5,6,5,23,61
278,Zach LaVine\lavinza01,SG,24,CHI,58,58,2009,510,1139,.448,177,463,.382,333,676,.493,.525,266,326,.816,39,242,281,243,86,28,200,122,1463
279,Vic Law\lawvi01,SF,24,ORL,3,0,4,0,2,.000,0,1,.000,0,1,.000,.000,0,2,.000,0,0,0,0,0,0,0,0,0
280,Jake Layman\laymaja01,PF,25,MIN,14,2,369,61,132,.462,19,54,.352,42,78,.538,.534,6,10,.600,12,29,41,11,12,10,18,31,147
281,T.J. Leaf\leaftj01,PF,22,IND,23,1,185,28,67,.418,5,14,.357,23,53,.434,.455,7,12,.583,20,41,61,6,8,3,6,18,68
282,Jalen Lecque\lecquja01,PG,19,PHO,4,0,26,4,10,.400,0,4,.000,4,6,.667,.400,2,2,1.000,0,0,0,2,0,0,1,2,10
283,Courtney Lee\leeco01,SG,34,DAL,15,4,163,22,43,.512,13,28,.464,9,15,.600,.663,1,2,.500,2,11,13,7,6,4,3,17,58
284,Damion Lee\leeda03,SG,27,GSW,41,28,1154,173,414,.418,63,178,.354,110,236,.466,.494,94,106,.887,30,167,197,103,41,4,56,95,503
285,Alex Len\lenal01,C,26,TOT,41,9,761,143,263,.544,14,56,.250,129,207,.623,.570,52,83,.627,73,165,238,42,21,34,42,97,352
285,Alex Len\lenal01,C,26,ATL,40,9,745,142,260,.546,14,56,.250,128,204,.627,.573,51,81,.630,69,161,230,42,20,33,39,93,349
285,Alex Len\lenal01,C,26,SAC,1,0,16,1,3,.333,0,0,,1,3,.333,.333,1,2,.500,4,4,8,0,1,1,3,4,3
286,Kawhi Leonard\leonaka01,SF,28,LAC,43,43,1400,408,883,.462,93,245,.380,315,638,.494,.515,263,293,.898,43,280,323,227,78,29,129,83,1172
287,Meyers Leonard\leoname01,C,27,MIA,49,49,987,116,223,.520,51,119,.429,65,104,.625,.635,17,26,.654,27,221,248,53,13,15,35,103,300
288,Caris LeVert\leverca01,SG,25,BRK,30,16,832,174,439,.396,47,127,.370,127,312,.407,.450,74,104,.712,28,82,110,107,33,5,77,54,469
289,Damian Lillard\lillada01,PG,29,POR,54,54,1996,507,1102,.460,212,539,.393,295,563,.524,.556,368,414,.889,28,207,235,429,52,18,158,91,1594
290,Nassir Little\littlna01,PF,19,POR,41,5,520,59,136,.434,14,54,.259,45,82,.549,.485,26,39,.667,31,72,103,19,10,14,15,68,158
291,Kevon Looney\looneke01,C,23,GSW,17,4,213,21,62,.339,1,11,.091,20,51,.392,.347,6,9,.667,23,30,53,13,11,4,9,29,49
292,Brook Lopez\lopezbr01,C,31,MIL,54,53,1441,212,495,.428,74,252,.294,138,243,.568,.503,81,97,.835,34,208,242,91,37,135,53,124,579
293,Robin Lopez\lopezro01,C,31,MIL,52,2,717,117,233,.502,23,79,.291,94,154,.610,.552,23,43,.535,47,83,130,35,8,35,43,62,280
294,Kevin Love\loveke01,PF,31,CLE,47,47,1461,277,608,.456,121,318,.381,156,290,.538,.555,146,172,.849,40,410,450,139,28,15,117,74,821
295,Kyle Lowry\lowryky01,PG,33,TOR,45,45,1635,267,635,.420,129,361,.357,138,274,.504,.522,210,245,.857,28,188,216,348,59,19,133,142,873
296,Timothé Luwawu-Cabarrot\luwawti01,SG,24,BRK,30,0,463,55,129,.426,28,68,.412,27,61,.443,.535,34,43,.791,17,51,68,15,13,3,25,53,172
297,Trey Lyles\lylestr01,PF,24,SAS,56,46,1040,118,268,.440,48,132,.364,70,136,.515,.530,22,32,.688,63,249,312,58,19,22,33,85,306
298,Daryl Macon\maconda01,SG,24,MIA,4,0,14,1,3,.333,1,2,.500,0,1,.000,.500,0,0,,0,0,0,1,0,0,2,1,3
299,J.P. Macura\macurjp01,SG,24,CLE,1,0,1,0,0,,0,0,,0,0,,,0,0,,0,0,0,0,0,0,0,0,0
300,Josh Magette\magetjo01,PG,30,ORL,8,0,38,5,15,.333,1,4,.250,4,11,.364,.367,1,2,.500,1,5,6,5,3,1,5,4,12
301,Ian Mahinmi\mahinia01,C,33,WAS,35,32,750,97,194,.500,5,24,.208,92,170,.541,.513,68,107,.636,74,131,205,47,27,43,45,105,267
302,Thon Maker\makerth01,C,22,DET,54,13,696,85,168,.506,20,58,.345,65,110,.591,.565,68,102,.667,49,98,147,37,21,35,44,90,258
303,Terance Mann\mannte01,SG,23,LAC,35,6,271,22,54,.407,3,12,.250,19,42,.452,.435,9,12,.750,4,29,33,38,8,5,14,36,56
304,Boban Marjanović\marjabo01,C,31,DAL,29,1,258,67,123,.545,3,9,.333,64,114,.561,.557,27,37,.730,37,78,115,11,4,6,20,40,164
305,Lauri Markkanen\markkla01,PF,22,CHI,46,46,1395,233,550,.424,101,294,.344,132,256,.516,.515,123,149,.826,57,241,298,70,39,22,77,92,690
306,Caleb Martin\martica02,SF,24,CHO,9,1,107,8,25,.320,2,8,.250,6,17,.353,.360,4,7,.571,2,12,14,7,3,2,5,14,22
307,Cody Martin\martico01,SF,24,CHO,39,1,633,63,150,.420,14,59,.237,49,91,.538,.467,30,47,.638,29,83,112,55,28,7,29,59,170
308,Jeremiah Martin\martije02,PG,23,BRK,2,0,11,1,4,.250,0,0,,1,4,.250,.250,0,0,,0,1,1,1,1,0,0,0,2
309,Kelan Martin\martike03,SF,24,MIN,24,4,416,57,150,.380,21,79,.266,36,71,.507,.450,20,20,1.000,7,72,79,13,6,9,14,42,155
310,Frank Mason\masonfr01,PG,25,MIL,4,0,18,1,7,.143,1,4,.250,0,3,.000,.214,2,4,.500,1,1,2,5,1,0,1,2,5
311,Garrison Mathews\mathega01,SG,23,WAS,16,0,202,23,50,.460,18,42,.429,5,8,.625,.640,29,32,.906,6,17,23,10,3,1,7,26,93
312,Wesley Matthews\matthwe02,SG,33,MIL,53,53,1302,134,329,.407,85,228,.373,49,101,.485,.536,41,53,.774,12,118,130,78,30,9,36,79,394
313,Patrick McCaw\mccawpa01,SF,24,TOR,31,11,747,60,137,.438,21,58,.362,39,79,.494,.515,12,16,.750,16,51,67,70,33,4,25,48,153
314,CJ McCollum\mccolcj01,SG,28,POR,54,54,1937,465,1038,.448,149,385,.387,316,653,.484,.520,96,128,.750,34,184,218,217,39,33,97,135,1175
315,T.J. McConnell\mccontj01,PG,27,IND,55,3,1039,166,319,.520,4,13,.308,162,306,.529,.527,29,35,.829,28,117,145,281,39,11,76,57,365
316,Jalen McDaniels\mcdanja01,PF,22,CHO,7,0,104,13,25,.520,5,10,.500,8,15,.533,.620,5,6,.833,4,19,23,2,3,0,1,13,36
317,Doug McDermott\mcderdo01,PF,28,IND,57,0,1167,222,455,.488,110,248,.444,112,207,.541,.609,40,49,.816,22,121,143,63,7,4,35,100,594
318,JaVale McGee\mcgeeja01,C,32,LAL,53,53,885,162,252,.643,3,6,.500,159,246,.646,.649,43,67,.642,98,210,308,33,26,82,40,127,370
319,Rodney McGruder\mcgruro01,SG,28,LAC,44,3,709,56,147,.381,20,75,.267,36,72,.500,.449,13,26,.500,25,97,122,29,22,8,20,66,145
320,Alfonzo McKinnie\mckinal01,SF,27,CLE,37,1,531,63,152,.414,12,59,.203,51,93,.548,.454,20,29,.690,31,71,102,13,21,6,23,64,158
321,Jordan McLaughlin\mclaujo01,PG,23,MIN,21,2,410,58,126,.460,22,57,.386,36,69,.522,.548,15,20,.750,4,34,38,86,21,4,17,20,153
322,Ben McLemore\mclembe01,SG,26,HOU,56,18,1309,193,435,.444,142,362,.392,51,73,.699,.607,44,58,.759,18,107,125,50,35,12,42,113,572
323,Jordan McRae\mcraejo01,SG,28,TOT,32,4,681,135,322,.419,42,110,.382,93,212,.439,.484,67,87,.770,18,91,109,86,20,16,38,63,379
323,Jordan McRae\mcraejo01,SG,28,WAS,29,4,654,133,317,.420,40,106,.377,93,211,.441,.483,64,83,.771,17,87,104,82,19,15,38,61,370
323,Jordan McRae\mcraejo01,SG,28,DEN,3,0,27,2,5,.400,2,4,.500,0,1,.000,.600,3,4,.750,1,4,5,4,1,1,0,2,9
324,Nicolò Melli\mellini01,C,29,NOP,45,6,722,104,224,.464,58,146,.397,46,78,.590,.594,30,39,.769,30,100,130,50,25,15,34,86,296
325,De'Anthony Melton\meltode01,PG,21,MEM,43,0,802,124,287,.432,25,84,.298,99,203,.488,.476,80,95,.842,28,128,156,129,55,14,63,77,353
326,Chimezie Metu\metuch01,PF,22,SAS,16,0,73,20,35,.571,0,1,.000,20,34,.588,.571,6,8,.750,10,16,26,6,1,4,5,4,46
327,Khris Middleton\middlkh01,SF,28,MIL,49,46,1453,371,731,.508,120,271,.443,251,460,.546,.590,152,168,.905,39,267,306,207,46,7,99,106,1014
328,Eric Mika\mikaer01,PF,25,SAC,1,0,19,2,3,.667,0,0,,2,3,.667,.667,2,2,1.000,2,5,7,0,0,0,0,5,6
329,C.J. Miles\milescj01,SG,32,WAS,10,0,161,19,59,.322,11,35,.314,8,24,.333,.415,15,20,.750,4,8,12,12,10,4,4,14,64
330,Malcolm Miller\millema01,SF,26,TOR,24,1,124,8,23,.348,6,18,.333,2,5,.400,.478,1,6,.167,1,13,14,8,4,2,3,12,23
331,Patty Mills\millspa02,PG,31,SAS,56,1,1281,221,518,.427,134,348,.385,87,170,.512,.556,80,95,.842,18,72,90,103,44,5,47,85,656
332,Paul Millsap\millspa01,PF,34,DEN,37,34,908,157,324,.485,41,91,.451,116,233,.498,.548,96,113,.850,72,149,221,57,33,26,46,105,451
333,Shake Milton\miltosh01,SG,23,PHI,24,8,364,55,125,.440,24,65,.369,31,60,.517,.536,26,33,.788,6,40,46,36,9,1,25,41,160
334,Donovan Mitchell\mitchdo01,SG,23,UTA,55,55,1892,494,1082,.457,132,367,.360,362,715,.506,.518,211,245,.861,36,201,237,234,59,11,148,133,1331
335,Naz Mitrou-Long\mitrona01,SG,26,IND,3,0,43,6,16,.375,2,11,.182,4,5,.800,.438,0,0,,0,6,6,7,1,1,2,1,14
336,Adam Mokoka\mokokad01,SG,21,CHI,8,0,57,7,19,.368,3,9,.333,4,10,.400,.447,0,2,.000,6,1,7,3,2,0,1,8,17
337,Malik Monk\monkma01,SG,21,CHO,54,0,1142,208,475,.438,58,200,.290,150,275,.545,.499,82,100,.820,26,130,156,111,24,16,77,72,556
338,Matt Mooney\moonema01,SG,22,CLE,2,0,5,1,2,.500,0,1,.000,1,1,1.000,.500,0,0,,0,1,1,1,0,1,0,1,2
339,E'Twaun Moore\mooreet01,SG,30,NOP,44,5,861,162,380,.426,56,150,.373,106,230,.461,.500,27,41,.659,28,83,111,67,24,8,32,68,407
340,Ja Morant\moranja01,PG,20,MEM,50,50,1495,333,677,.492,38,107,.355,295,570,.518,.520,178,229,.777,32,140,172,345,48,13,164,79,882
341,Juwan Morgan\morgaju01,PF,22,UTA,15,0,68,9,16,.563,1,4,.250,8,12,.667,.594,0,0,,5,14,19,2,0,1,3,7,19
342,Marcus Morris\morrima03,SF-PF,30,TOT,47,47,1518,298,677,.440,121,282,.429,177,395,.448,.530,163,198,.823,50,202,252,65,37,21,82,140,880
342,Marcus Morris\morrima03,SF,30,NYK,43,43,1387,281,636,.442,116,264,.439,165,372,.444,.533,163,198,.823,48,185,233,59,34,17,73,128,841
342,Marcus Morris\morrima03,PF,30,LAC,4,4,131,17,41,.415,5,18,.278,12,23,.522,.476,0,0,,2,17,19,6,3,4,9,12,39
343,Markieff Morris\morrima02,PF,30,DET,44,16,988,175,389,.450,75,189,.397,100,200,.500,.546,61,79,.772,24,149,173,69,26,11,70,104,486
344,Monte Morris\morrimo01,PG,24,DEN,57,8,1214,197,427,.461,48,124,.387,149,303,.492,.518,44,55,.800,20,84,104,205,44,11,38,56,486
345,Johnathan Motley\motlejo01,PF,24,LAC,13,0,41,11,15,.733,1,1,1.000,10,14,.714,.767,5,7,.714,3,7,10,8,3,0,5,6,28
346,Emmanuel Mudiay\mudiaem01,PG,23,UTA,46,1,742,134,284,.472,27,75,.360,107,209,.512,.519,50,67,.746,17,97,114,107,19,10,63,61,345
347,Dejounte Murray\murrade01,PG,23,SAS,52,44,1284,221,458,.483,29,75,.387,192,383,.501,.514,70,88,.795,60,240,300,209,87,13,97,112,541
348,Jamal Murray\murraja01,PG,22,DEN,47,47,1528,332,726,.457,85,251,.339,247,475,.520,.516,140,157,.892,35,149,184,224,58,14,107,81,889
349,Džanan Musa\musadz01,SF,20,BRK,35,0,404,50,139,.360,15,65,.231,35,74,.473,.414,33,44,.750,19,52,71,31,13,1,29,25,148
350,Mike Muscala\muscami01,C,28,OKC,38,0,468,62,150,.413,41,113,.363,21,37,.568,.550,18,22,.818,13,77,90,31,7,10,13,46,183
351,Sviatoslav Mykhailiuk\mykhasv01,SF,22,DET,49,20,1081,142,332,.428,97,234,.415,45,98,.459,.574,49,57,.860,15,70,85,80,31,4,51,72,430
352,Abdel Nader\naderab01,SF,26,OKC,41,5,627,85,181,.470,32,89,.360,53,92,.576,.558,38,48,.792,11,54,65,26,16,12,33,53,240
353,Larry Nance\nancela02,C,27,CLE,47,8,1182,182,347,.524,46,136,.338,136,211,.645,.591,40,59,.678,86,255,341,91,40,21,50,76,450
354,Shabazz Napier\napiesh01,PG,28,TOT,42,22,969,130,319,.408,56,181,.309,74,138,.536,.495,81,98,.827,20,101,121,210,49,8,88,70,397
354,Shabazz Napier\napiesh01,PG,28,MIN,36,22,856,114,283,.403,47,159,.296,67,124,.540,.486,72,88,.818,17,93,110,187,40,7,76,62,347
354,Shabazz Napier\napiesh01,PG,28,WAS,6,0,113,16,36,.444,9,22,.409,7,14,.500,.569,9,10,.900,3,8,11,23,9,1,12,8,50
355,Raul Neto\netora01,PG,27,PHI,46,3,515,68,158,.430,24,65,.369,44,93,.473,.506,18,22,.818,11,39,50,68,21,5,36,38,178
356,Malik Newman\newmama01,SG,22,CLE,1,0,4,0,2,.000,0,1,.000,0,1,.000,.000,2,2,1.000,0,0,0,0,0,0,1,0,2
357,Georges Niang\niangge01,PF,26,UTA,50,0,677,103,225,.458,65,155,.419,38,70,.543,.602,19,22,.864,11,85,96,34,12,5,25,59,290
358,Nerlens Noel\noelne01,C,25,OKC,48,6,891,155,228,.680,1,3,.333,154,225,.684,.682,70,88,.795,76,165,241,50,51,72,46,125,381
359,Zach Norvell\norveza01,SG,22,TOT,5,0,41,3,12,.250,3,8,.375,0,4,.000,.375,1,1,1.000,0,6,6,3,2,0,3,4,10
359,Zach Norvell\norveza01,SG,22,LAL,2,0,5,0,1,.000,0,0,,0,1,.000,.000,0,0,,0,1,1,0,0,0,0,0,0
359,Zach Norvell\norveza01,SG,22,GSW,3,0,36,3,11,.273,3,8,.375,0,3,.000,.409,1,1,1.000,0,5,5,3,2,0,3,4,10
360,Jaylen Nowell\nowelja01,SG,20,MIN,10,0,117,16,44,.364,3,23,.130,13,21,.619,.398,11,12,.917,3,7,10,13,0,1,3,6,46
361,Frank Ntilikina\ntilila01,PG,21,NYK,50,26,1041,110,286,.385,36,116,.310,74,170,.435,.448,40,46,.870,21,89,110,149,47,16,64,124,296
362,Kendrick Nunn\nunnke01,SG,24,MIA,53,53,1590,322,726,.444,105,301,.349,217,425,.511,.516,71,84,.845,14,127,141,187,47,11,91,118,820
363,David Nwaba\nwabada01,SF,27,BRK,20,0,268,37,71,.521,12,28,.429,25,43,.581,.606,18,27,.667,8,37,45,8,11,12,8,32,104
364,Royce O'Neale\onealro01,PF,26,UTA,56,48,1624,121,272,.445,68,170,.400,53,102,.520,.570,26,31,.839,21,267,288,142,40,23,46,159,336
365,Kyle O'Quinn\oquinky01,C,29,PHI,22,1,221,32,64,.500,7,21,.333,25,43,.581,.555,5,11,.455,27,54,81,32,4,17,18,29,76
366,Semi Ojeleye\ojelese01,PF,25,BOS,53,4,772,51,129,.395,28,80,.350,23,49,.469,.504,24,27,.889,20,80,100,29,18,4,10,56,154
367,Jahlil Okafor\okafoja01,C,24,NOP,27,9,420,88,144,.611,1,2,.500,87,142,.613,.615,37,58,.638,46,71,117,36,7,19,36,62,214
368,Elie Okobo\okoboel01,PG,22,PHO,47,3,621,63,159,.396,23,65,.354,40,94,.426,.469,41,61,.672,14,59,73,101,22,4,30,45,190
369,Josh Okogie\okogijo01,SG,21,MIN,53,19,1299,145,348,.417,34,136,.250,111,212,.524,.466,136,172,.791,72,159,231,83,60,21,75,115,460
370,KZ Okpala\okpalkz01,SF,20,MIA,5,0,26,3,5,.600,0,1,.000,3,4,.750,.600,1,2,.500,1,4,5,1,2,1,1,2,7
371,Victor Oladipo\oladivi01,SG,27,IND,8,5,200,31,93,.333,11,44,.250,20,49,.408,.392,13,17,.765,6,11,17,21,4,1,16,12,86
372,Kelly Olynyk\olynyke01,C,28,MIA,50,4,972,128,279,.459,65,163,.399,63,116,.543,.575,63,73,.863,33,192,225,73,34,17,55,124,384
373,Miye Oni\onimi01,SG,22,UTA,3,0,8,0,0,,0,0,,0,0,,,0,0,,0,1,1,0,0,0,1,0,0
374,Cedi Osman\osmande01,SF,24,CLE,56,56,1628,230,517,.445,106,275,.385,124,242,.512,.547,51,80,.638,28,174,202,135,46,15,78,135,617
375,Kelly Oubre\oubreke01,SF,24,PHO,55,54,1895,366,813,.450,107,304,.352,259,509,.509,.516,189,242,.781,67,291,358,83,70,39,82,188,1028
376,Tariq Owens\owensta01,PF,24,PHO,3,0,15,1,5,.200,0,2,.000,1,3,.333,.200,2,2,1.000,2,1,3,0,1,0,0,1,4
377,Jeremy Pargo\pargoje01,PG,33,GSW,3,0,44,11,22,.500,3,7,.429,8,15,.533,.568,0,1,.000,1,2,3,8,1,0,4,8,25
378,Jabari Parker\parkeja01,PF,24,TOT,33,23,852,199,399,.499,31,116,.267,168,283,.594,.538,55,74,.743,54,141,195,60,42,15,60,94,484
378,Jabari Parker\parkeja01,PF,24,ATL,32,23,837,198,393,.504,31,115,.270,167,278,.601,.543,53,72,.736,54,137,191,58,42,15,60,93,480
378,Jabari Parker\parkeja01,PF,24,SAC,1,0,15,1,6,.167,0,1,.000,1,5,.200,.167,2,2,1.000,0,4,4,2,0,0,0,1,4
379,Chandler Parsons\parsoch01,SF,31,ATL,5,0,54,5,18,.278,4,14,.286,1,4,.250,.389,0,0,,1,6,7,3,4,1,3,3,14
380,Eric Paschall\pascher01,PF,23,GSW,52,25,1397,263,541,.486,30,106,.283,233,435,.536,.514,131,169,.775,74,171,245,87,30,13,83,111,687
381,Anžejs Pasečņiks\pasecan01,C,24,WAS,20,0,370,54,102,.529,0,2,.000,54,100,.540,.529,31,50,.620,37,57,94,17,8,10,22,58,139
382,Patrick Patterson\pattepa01,PF,30,LAC,46,18,578,71,178,.399,50,134,.373,21,44,.477,.539,27,34,.794,29,88,117,29,6,3,15,40,219
383,Justin Patton\pattoju01,C,22,OKC,5,0,24,4,10,.400,1,4,.250,3,6,.500,.450,0,0,,1,4,5,2,0,0,2,4,9
384,Chris Paul\paulch01,PG,34,OKC,56,56,1777,345,709,.487,92,252,.365,253,457,.554,.551,199,222,.896,20,265,285,373,86,8,120,128,981
385,Elfrid Payton\paytoel01,PG,25,NYK,36,27,988,153,356,.430,14,59,.237,139,297,.468,.449,30,56,.536,43,126,169,247,61,16,72,74,350
386,Gary Payton\paytoga02,PG,27,WAS,24,17,407,44,108,.407,12,41,.293,32,67,.478,.463,4,8,.500,25,48,73,45,32,7,19,48,104
387,Norvel Pelle\pelleno01,C,26,PHI,17,0,170,18,33,.545,0,0,,18,33,.545,.545,6,12,.500,15,43,58,7,1,25,13,36,42
388,Theo Pinson\pinsoth01,SG,24,BRK,29,0,346,45,152,.296,15,78,.192,30,74,.405,.345,15,16,.938,10,41,51,53,15,2,32,33,120
389,Mason Plumlee\plumlma01,C,29,DEN,45,1,778,133,217,.613,0,4,.000,133,213,.624,.613,64,116,.552,80,165,245,109,25,27,66,101,330
390,Vincent Poirier\poirivi01,C,26,BOS,19,0,111,15,31,.484,1,2,.500,14,29,.483,.500,6,7,.857,10,24,34,7,2,6,6,22,37
391,Jakob Pöltl\poeltja01,C,24,SAS,56,9,951,133,215,.619,0,0,,133,215,.619,.619,35,70,.500,103,203,306,100,30,84,44,95,301
392,Shamorie Ponds\pondssh01,PG,21,TOR,4,0,11,3,5,.600,1,2,.500,2,3,.667,.700,2,2,1.000,0,1,1,2,0,1,0,2,9
393,Jordan Poole\poolejo01,SG,20,GSW,50,12,1097,135,436,.310,62,233,.266,73,203,.360,.381,82,99,.828,7,99,106,102,31,9,56,82,414
394,Kevin Porter\porteke02,SF,19,CLE,44,2,979,158,350,.451,43,126,.341,115,224,.513,.513,57,80,.713,17,119,136,86,39,10,84,121,416
395,Michael Porter\portemi01,PF,21,DEN,41,1,573,124,247,.502,38,90,.422,86,157,.548,.579,31,39,.795,44,132,176,29,17,18,31,69,317
396,Otto Porter\porteot01,SF,26,CHI,9,9,226,35,84,.417,16,40,.400,19,44,.432,.512,15,20,.750,8,23,31,14,9,3,7,20,101
397,Bobby Portis\portibo01,C,24,NYK,56,4,1169,210,484,.434,58,163,.356,152,321,.474,.494,60,79,.759,76,220,296,87,28,11,63,98,538
398,Kristaps Porziņģis\porzikr01,PF,24,DAL,43,43,1317,274,655,.418,101,286,.353,173,369,.469,.495,149,191,.780,70,323,393,67,30,84,72,135,798
399,Dwight Powell\poweldw01,C,28,DAL,40,37,1061,146,229,.638,10,39,.256,136,190,.716,.659,74,111,.667,75,152,227,59,34,22,36,102,376
400,Norman Powell\powelno01,SG,26,TOR,38,17,1072,210,422,.498,77,192,.401,133,230,.578,.589,84,100,.840,22,125,147,64,48,14,57,76,581
401,Julius Randle\randlju01,PF,25,NYK,54,54,1770,386,853,.453,55,209,.263,331,644,.514,.485,203,287,.707,122,396,518,174,44,18,165,151,1030
402,Josh Reaves\reavejo02,SG,22,DAL,2,0,1,0,1,.000,0,0,,0,1,.000,.000,0,0,,0,0,0,0,0,0,0,0,0
403,Cam Reddish\reddica01,SF,20,ATL,50,32,1323,165,462,.357,63,207,.304,102,255,.400,.425,89,111,.802,32,157,189,78,54,24,80,115,482
404,J.J. Redick\redicjj01,SG,35,NOP,52,35,1401,251,558,.450,156,345,.452,95,213,.446,.590,144,160,.900,9,125,134,102,19,9,63,81,802
405,Naz Reid\reidna01,C,20,MIN,21,2,270,63,149,.423,25,70,.357,38,79,.481,.507,21,28,.750,19,47,66,16,10,10,14,54,172
406,Josh Richardson\richajo01,SG,26,PHI,43,41,1329,227,525,.432,66,199,.332,161,326,.494,.495,93,117,.795,34,106,140,136,42,27,89,113,613
407,Austin Rivers\riverau01,SG,27,HOU,52,4,1222,157,379,.414,70,205,.341,87,174,.500,.507,53,77,.688,19,107,126,81,37,9,31,94,437
408,Duncan Robinson\robindu01,SF,25,MIA,56,51,1639,236,516,.457,197,454,.434,39,62,.629,.648,41,46,.891,8,170,178,80,28,13,45,160,710
409,Glenn Robinson\robingl02,SF,26,TOT,52,50,1574,257,530,.485,68,176,.386,189,354,.534,.549,63,74,.851,67,165,232,88,51,15,51,86,645
409,Glenn Robinson\robingl02,SF,26,GSW,48,48,1516,244,507,.481,68,170,.400,176,337,.522,.548,63,74,.851,66,160,226,85,45,14,50,82,619
409,Glenn Robinson\robingl02,SF,26,PHI,4,2,58,13,23,.565,0,6,.000,13,17,.765,.565,0,0,,1,5,6,3,6,1,1,4,26
410,Jerome Robinson\robinje01,SG,22,TOT,47,1,561,56,164,.341,23,78,.295,33,86,.384,.412,12,21,.571,6,73,79,52,15,8,28,67,147
410,Jerome Robinson\robinje01,SG,22,LAC,42,1,476,46,136,.338,19,67,.284,27,69,.391,.408,11,19,.579,5,55,60,46,13,8,26,55,122
410,Jerome Robinson\robinje01,SG,22,WAS,5,0,85,10,28,.357,4,11,.364,6,17,.353,.429,1,2,.500,1,18,19,6,2,0,2,12,25
411,Justin Robinson\robinju01,PG,22,WAS,9,0,49,5,12,.417,3,5,.600,2,7,.286,.542,0,0,,1,4,5,7,0,1,3,2,13
412,Mitchell Robinson\robinmi01,C,21,NYK,52,7,1171,204,279,.731,0,0,,204,279,.731,.731,68,117,.581,148,201,349,28,45,98,34,174,476
413,Isaiah Roby\robyis01,SF,21,OKC,2,0,5,0,1,.000,0,0,,0,1,.000,.000,0,0,,0,1,1,0,0,0,0,0,0
414,Rajon Rondo\rondora01,PG,33,LAL,40,2,836,120,279,.430,38,108,.352,82,171,.480,.498,26,39,.667,20,110,130,211,35,2,78,49,304
415,Derrick Rose\rosede01,PG,31,DET,47,12,1231,345,710,.486,42,141,.298,303,569,.533,.515,112,130,.862,24,89,113,267,36,15,118,46,844
416,Terrence Ross\rosste01,SG,28,ORL,54,0,1447,246,639,.385,121,375,.323,125,264,.473,.480,114,137,.832,13,153,166,59,61,19,53,78,727
417,Terry Rozier\roziete01,PG,25,CHO,55,55,1879,340,811,.419,143,367,.390,197,444,.444,.507,146,168,.869,44,204,248,221,57,10,128,113,969
418,Ricky Rubio\rubiori01,PG,29,PHO,49,49,1535,210,522,.402,53,158,.335,157,364,.431,.453,134,161,.832,35,182,217,423,70,9,131,120,607
419,D'Angelo Russell\russeda01,PG,23,TOT,36,36,1161,294,686,.429,129,347,.372,165,339,.487,.523,128,160,.800,15,119,134,235,34,10,113,70,845
419,D'Angelo Russell\russeda01,PG,23,GSW,33,33,1060,273,635,.430,120,321,.374,153,314,.487,.524,113,144,.785,14,108,122,206,31,9,101,64,779
419,D'Angelo Russell\russeda01,PG,23,MIN,3,3,101,21,51,.412,9,26,.346,12,25,.480,.500,15,16,.938,1,11,12,29,3,1,12,6,66
420,Domantas Sabonis\sabondo01,C,23,IND,54,54,1867,393,733,.536,13,58,.224,380,675,.563,.545,188,258,.729,164,509,673,259,40,28,147,180,987
421,JaKarr Sampson\sampsja02,SF,26,IND,19,10,256,35,61,.574,2,12,.167,33,49,.673,.590,4,10,.400,11,33,44,4,6,8,6,33,76
422,Dario Šarić\saricda01,PF,25,PHO,50,43,1213,175,397,.441,59,189,.312,116,208,.558,.515,61,72,.847,76,218,294,94,30,12,63,111,470
423,Tomáš Satoranský\satorto01,PG,28,CHI,58,58,1671,216,490,.441,62,183,.339,154,307,.502,.504,98,113,.867,62,154,216,316,76,7,111,121,592
424,Admiral Schofield\schofad01,SF,22,WAS,26,2,292,30,75,.400,14,47,.298,16,28,.571,.493,9,13,.692,6,28,34,14,8,3,7,41,83
425,Dennis Schröder\schrode01,PG,26,OKC,56,1,1742,396,842,.470,111,289,.384,285,553,.515,.536,163,192,.849,19,196,215,226,37,13,143,123,1066
426,Mike Scott\scottmi01,PF,31,PHI,56,7,959,110,278,.396,62,182,.341,48,96,.500,.507,24,27,.889,44,143,187,32,17,4,20,68,306
427,Thabo Sefolosha\sefolth01,PF,35,HOU,39,0,417,37,89,.416,15,53,.283,22,36,.611,.500,3,8,.375,21,69,90,24,23,12,14,42,92
428,Collin Sexton\sextoco01,SG,21,CLE,56,56,1805,423,923,.458,77,210,.367,346,713,.485,.500,188,221,.851,55,121,176,157,54,7,124,120,1111
429,Landry Shamet\shamela01,SG,22,LAC,39,27,1145,133,309,.430,95,235,.404,38,74,.514,.584,46,51,.902,4,75,79,73,17,8,31,117,407
430,Marial Shayok\shayoma01,SG,24,PHI,2,0,10,1,5,.200,1,3,.333,0,2,.000,.300,0,0,,0,3,3,1,0,0,1,0,3
431,Iman Shumpert\shumpim01,SG,29,BRK,13,0,241,21,64,.328,8,33,.242,13,31,.419,.391,4,7,.571,9,25,34,12,12,2,10,21,54
432,Pascal Siakam\siakapa01,PF,25,TOR,46,46,1607,405,872,.464,99,270,.367,306,602,.508,.521,182,225,.809,53,293,346,158,44,43,110,125,1091
433,Chris Silva\silvach01,PF,23,MIA,38,0,294,42,66,.636,0,2,.000,42,64,.656,.636,32,47,.681,51,54,105,19,9,17,31,78,116
434,Ben Simmons\simmobe01,PG,23,PHI,54,54,1930,361,617,.585,2,6,.333,359,611,.588,.587,178,284,.627,108,315,423,442,115,32,192,173,902
435,Anfernee Simons\simonan01,SG,20,POR,57,4,1265,191,471,.406,66,197,.335,125,274,.456,.476,67,83,.807,22,117,139,86,20,9,54,114,515
436,Alen Smailagić\smailal01,PF,19,GSW,14,0,139,20,40,.500,3,13,.231,17,27,.630,.538,16,19,.842,10,17,27,13,3,4,11,14,59
437,Marcus Smart\smartma01,SG,25,BOS,45,31,1429,188,493,.381,102,289,.353,86,204,.422,.485,85,105,.810,31,133,164,216,72,22,74,119,563
438,Dennis Smith\smithde03,PG,22,NYK,31,2,480,61,182,.335,15,50,.300,46,132,.348,.376,22,46,.478,19,51,70,90,21,8,52,58,159
439,Ish Smith\smithis01,PG,31,WAS,55,18,1457,245,541,.453,51,143,.357,194,398,.487,.500,45,67,.672,27,149,176,261,48,23,69,78,586
440,Zhaire Smith\smithzh01,SG,20,PHI,7,0,32,3,11,.273,0,3,.000,3,8,.375,.273,2,4,.500,0,2,2,2,3,0,2,4,8
441,Tony Snell\snellto01,SF,28,DET,52,50,1420,152,336,.452,93,226,.412,59,110,.536,.591,22,22,1.000,7,85,92,96,25,12,26,83,419
442,Omari Spellman\spellom01,PF,22,GSW,49,3,886,127,295,.431,43,110,.391,84,185,.454,.503,73,92,.793,77,142,219,47,33,24,54,63,370
443,Max Strus\strusma01,SG,23,CHI,2,0,6,2,3,.667,0,1,.000,2,2,1.000,.667,1,1,1.000,1,0,1,0,0,0,0,1,5
444,Edmond Sumner\sumneed01,PG,24,IND,20,2,268,35,80,.438,8,26,.308,27,54,.500,.488,8,13,.615,8,21,29,28,13,6,15,28,86
445,Caleb Swanigan\swanica01,PF,22,TOT,19,1,208,20,38,.526,0,2,.000,20,36,.556,.526,5,12,.417,22,51,73,16,2,6,24,42,45
445,Caleb Swanigan\swanica01,PF,22,SAC,7,0,23,2,4,.500,0,0,,2,4,.500,.500,1,2,.500,2,5,7,2,1,2,6,8,5
445,Caleb Swanigan\swanica01,PF,22,POR,12,1,185,18,34,.529,0,2,.000,18,32,.563,.529,4,10,.400,20,46,66,14,1,4,18,34,40
446,Jayson Tatum\tatumja01,PF,21,BOS,52,52,1779,426,957,.445,139,360,.386,287,597,.481,.518,199,242,.822,54,309,363,151,71,47,113,110,1190
447,Jeff Teague\teaguje01,PG,31,TOT,50,16,1289,185,426,.434,38,103,.369,147,323,.455,.479,155,178,.871,21,99,120,279,40,16,105,97,563
447,Jeff Teague\teaguje01,PG,31,MIN,34,13,945,145,324,.448,33,87,.379,112,237,.473,.498,125,144,.868,15,73,88,208,25,13,76,70,448
447,Jeff Teague\teaguje01,PG,31,ATL,16,3,344,40,102,.392,5,16,.313,35,86,.407,.417,30,34,.882,6,26,32,71,15,3,29,27,115
448,Garrett Temple\templga01,SG,33,BRK,50,31,1412,178,474,.376,102,312,.327,76,162,.469,.483,53,69,.768,25,149,174,123,40,21,53,89,511
449,Daniel Theis\theisda01,C,27,BOS,50,49,1159,177,317,.558,23,69,.333,154,248,.621,.595,64,87,.736,110,214,324,77,32,66,42,174,441
450,Isaiah Thomas\thomais02,PG,30,WAS,40,37,925,174,426,.408,78,189,.413,96,237,.405,.500,62,76,.816,11,57,68,146,13,6,77,77,488
451,Khyri Thomas\thomakh01,SG,23,DET,2,0,6,0,0,,0,0,,0,0,,,1,2,.500,0,0,0,0,0,0,0,0,1
452,Matt Thomas\thomama02,SG,25,TOR,26,0,267,45,88,.511,31,61,.508,14,27,.519,.688,5,7,.714,4,31,35,14,7,0,10,23,126
453,Tristan Thompson\thomptr01,C,28,CLE,52,48,1583,265,512,.518,8,16,.500,257,496,.518,.525,93,146,.637,213,321,534,108,32,46,98,114,631
454,Matisse Thybulle\thybuma01,SG,22,PHI,49,10,981,80,199,.402,47,128,.367,33,71,.465,.520,24,37,.649,26,49,75,58,69,40,41,109,231
455,Anthony Tolliver\tollian01,PF,34,TOT,42,9,636,46,134,.343,32,104,.308,14,30,.467,.463,14,21,.667,29,92,121,32,12,10,25,60,138
455,Anthony Tolliver\tollian01,PF,34,POR,33,9,554,43,117,.368,30,89,.337,13,28,.464,.496,13,19,.684,27,83,110,29,8,9,21,54,129
455,Anthony Tolliver\tollian01,PF,34,SAC,9,0,82,3,17,.176,2,15,.133,1,2,.500,.235,1,2,.500,2,9,11,3,4,1,4,6,9
456,Juan Toscano-Anderson\toscaju01,SF,26,GSW,5,0,100,16,28,.571,5,9,.556,11,19,.579,.661,1,1,1.000,1,20,21,11,6,3,6,7,38
457,Karl-Anthony Towns\townska01,C,24,MIN,35,35,1187,316,622,.508,114,277,.412,202,345,.586,.600,180,226,.796,95,283,378,153,33,42,110,117,926
458,Gary Trent\trentga02,SG,21,POR,45,4,838,114,266,.429,66,162,.407,48,104,.462,.553,21,24,.875,18,51,69,42,33,11,13,54,315
459,Allonzo Trier\trieral01,PG,24,NYK,20,1,246,37,85,.435,15,46,.326,22,39,.564,.524,31,39,.795,4,22,26,24,2,4,20,24,120
460,P.J. Tucker\tuckepj01,PF,34,HOU,56,56,1952,148,336,.440,85,227,.374,63,109,.578,.567,37,44,.841,85,301,386,89,64,24,59,185,418
461,Rayjon Tucker\tuckera01,SG,22,UTA,13,0,75,8,19,.421,0,6,.000,8,13,.615,.421,3,5,.600,2,10,12,2,1,0,3,7,19
462,Evan Turner\turneev01,PG,31,ATL,19,0,251,25,67,.373,0,5,.000,25,62,.403,.373,12,14,.857,8,30,38,38,9,8,26,20,62
463,Myles Turner\turnemy01,C,23,IND,47,47,1367,194,434,.447,66,197,.335,128,237,.540,.523,96,126,.762,55,236,291,56,36,89,60,117,550
464,Jonas Valančiūnas\valanjo01,C,27,MEM,53,53,1371,327,562,.582,27,72,.375,300,490,.612,.606,93,129,.721,152,408,560,97,24,62,95,141,774
465,Denzel Valentine\valende01,SF,26,CHI,30,0,366,66,164,.402,36,101,.356,30,63,.476,.512,5,5,1.000,4,53,57,34,20,5,20,40,173
466,Jarred Vanderbilt\vandeja01,SF-PF,20,TOT,11,0,46,5,8,.625,0,1,.000,5,7,.714,.625,2,2,1.000,3,6,9,2,3,1,7,6,12
466,Jarred Vanderbilt\vandeja01,SF,20,DEN,9,0,41,5,7,.714,0,0,,5,7,.714,.714,0,0,,3,5,8,2,3,1,7,6,10
466,Jarred Vanderbilt\vandeja01,PF,20,MIN,2,0,5,0,1,.000,0,1,.000,0,0,,.000,2,2,1.000,0,1,1,0,0,0,0,0,2
467,Fred VanVleet\vanvlfr01,PG,25,TOR,47,47,1682,282,687,.410,128,329,.389,154,358,.430,.504,139,165,.842,18,160,178,316,90,13,107,113,831
468,Gabe Vincent\vincega01,PG,23,MIA,4,0,41,4,19,.211,4,16,.250,0,3,.000,.316,0,0,,0,3,3,3,1,0,0,2,12
469,Noah Vonleh\vonleno01,C-PF,24,TOT,31,1,361,49,88,.557,3,15,.200,46,73,.630,.574,24,30,.800,35,86,121,26,11,6,21,38,125
469,Noah Vonleh\vonleno01,C,24,MIN,29,1,347,47,86,.547,2,14,.143,45,72,.625,.558,23,28,.821,34,82,116,26,11,6,19,36,119
469,Noah Vonleh\vonleno01,PF,24,DEN,2,0,14,2,2,1.000,1,1,1.000,1,1,1.000,1.250,1,2,.500,1,4,5,0,0,0,2,2,6
470,Nikola Vučević\vucevni01,C,29,ORL,45,45,1452,347,758,.458,75,222,.338,272,536,.507,.507,92,118,.780,119,369,488,165,43,42,65,101,861
471,Dean Wade\wadede01,PF,23,CLE,10,0,54,7,10,.700,2,3,.667,5,7,.714,.800,0,1,.000,2,14,16,1,2,3,3,7,16
472,Moritz Wagner\wagnemo01,C,22,WAS,28,4,557,116,202,.574,23,65,.354,93,137,.679,.631,48,60,.800,37,119,156,36,18,16,50,100,303
473,Dion Waiters\waitedi01,SG,28,MIA,3,0,42,10,26,.385,8,17,.471,2,9,.222,.538,0,1,.000,0,11,11,3,0,2,3,5,28
474,Kemba Walker\walkeke02,PG,29,BOS,46,46,1481,332,773,.429,156,402,.388,176,371,.474,.530,181,209,.866,31,158,189,230,45,25,97,73,1001
475,Lonnie Walker\walkelo01,SG,21,SAS,48,3,670,104,241,.432,24,63,.381,80,178,.449,.481,38,53,.717,18,82,100,37,24,9,27,59,270
476,Tyrone Wallace\wallaty01,SG,25,ATL,14,0,160,14,44,.318,1,15,.067,13,29,.448,.330,11,17,.647,3,19,22,13,7,1,10,19,40
477,Taurean Waller-Prince\princta02,SF,25,BRK,55,55,1625,246,640,.384,133,378,.352,113,262,.431,.488,55,71,.775,43,292,335,109,51,23,110,133,680
478,Derrick Walton\waltode01,PG,24,LAC,23,1,222,17,36,.472,9,21,.429,8,15,.533,.597,7,9,.778,2,13,15,22,4,0,4,19,50
479,Brad Wanamaker\wanambr01,PG,30,BOS,55,0,1040,118,281,.420,29,78,.372,89,203,.438,.472,94,102,.922,15,95,110,146,40,11,61,103,359
480,T.J. Warren\warretj01,SF,26,IND,54,54,1743,399,761,.524,60,163,.368,339,598,.567,.564,139,173,.803,53,154,207,75,65,25,64,148,997
481,P.J. Washington\washipj01,PF,21,CHO,49,48,1482,221,475,.465,64,167,.383,157,308,.510,.533,76,115,.661,46,223,269,104,47,39,79,134,582
482,Yuta Watanabe\watanyu01,SG,25,MEM,9,0,49,6,14,.429,2,4,.500,4,10,.400,.500,2,4,.500,1,7,8,1,1,1,1,5,16
483,Tremont Waters\watertr01,PG,22,BOS,9,0,73,10,28,.357,2,15,.133,8,13,.615,.393,6,6,1.000,0,7,7,10,5,2,8,10,28
484,Paul Watson\watsopa01,SF-SG,25,TOT,5,0,25,0,8,.000,0,4,.000,0,4,.000,.000,1,2,.500,0,4,4,5,1,1,0,1,1
484,Paul Watson\watsopa01,SG,25,ATL,2,0,17,0,7,.000,0,3,.000,0,4,.000,.000,0,0,,0,2,2,3,1,0,0,1,0
484,Paul Watson\watsopa01,SF,25,TOR,3,0,8,0,1,.000,0,1,.000,0,0,,.000,1,2,.500,0,2,2,2,0,1,0,0,1
485,Quinndary Weatherspoon\weathqu01,SG,23,SAS,1,0,4,0,1,.000,0,0,,0,1,.000,.000,0,0,,0,0,0,0,0,0,0,0,0
486,Russell Westbrook\westbru01,PG,31,HOU,47,47,1690,497,1066,.466,46,187,.246,451,879,.513,.488,238,302,.788,78,293,371,338,75,16,203,170,1278
487,Coby White\whiteco01,SG,19,CHI,58,0,1435,248,653,.380,110,317,.347,138,336,.411,.464,84,109,.771,26,175,201,139,44,6,92,101,690
488,Derrick White\whitede01,SG,25,SAS,54,11,1284,185,407,.455,50,138,.362,135,269,.502,.516,125,147,.850,28,138,166,181,31,43,62,109,545
489,Hassan Whiteside\whiteha01,C,30,POR,53,53,1640,349,572,.610,2,4,.500,347,568,.611,.612,138,198,.697,213,534,747,65,21,164,102,158,838
490,Andrew Wiggins\wiggian01,SF-SG,24,TOT,47,47,1617,387,863,.448,102,298,.342,285,565,.504,.508,165,230,.717,56,184,240,171,38,45,117,112,1041
490,Andrew Wiggins\wiggian01,SF,24,MIN,42,42,1455,351,790,.444,91,275,.331,260,515,.505,.502,149,207,.720,48,171,219,155,29,36,107,101,942
490,Andrew Wiggins\wiggian01,SG,24,GSW,5,5,162,36,73,.493,11,23,.478,25,50,.500,.568,16,23,.696,8,13,21,16,9,9,10,11,99
491,Grant Williams\willigr01,PF,21,BOS,54,4,835,72,171,.421,20,74,.270,52,97,.536,.480,37,51,.725,54,88,142,56,23,31,44,131,201
492,Johnathan Williams\willijo04,C,24,WAS,11,5,135,16,25,.640,0,2,.000,16,23,.696,.640,3,5,.600,15,28,43,6,1,6,4,11,35
493,Kenrich Williams\willike04,PF,25,NOP,35,18,779,49,143,.343,25,96,.260,24,47,.511,.430,9,24,.375,49,129,178,53,25,21,21,81,132
494,Lou Williams\willilo02,SG,33,LAC,53,8,1593,339,820,.413,95,271,.351,244,549,.444,.471,265,306,.866,25,142,167,310,34,10,160,74,1038
495,Marvin Williams\willima02,PF,33,TOT,44,1,856,99,220,.450,46,124,.371,53,96,.552,.555,45,52,.865,17,101,118,44,30,23,26,76,289
495,Marvin Williams\willima02,PF,33,CHO,41,1,808,94,210,.448,44,117,.376,50,93,.538,.552,43,50,.860,15,94,109,41,26,22,25,71,275
495,Marvin Williams\willima02,PF,33,MIL,3,0,48,5,10,.500,2,7,.286,3,3,1.000,.600,2,2,1.000,2,7,9,3,4,1,1,5,14
496,Robert Williams\williro04,C,22,BOS,19,1,269,33,49,.673,0,0,,33,49,.673,.673,8,14,.571,23,64,87,21,17,21,16,34,74
497,Nigel Williams-Goss\willini01,PG,25,UTA,9,0,28,1,7,.143,0,2,.000,1,5,.200,.143,2,2,1.000,2,3,5,5,1,1,2,2,4
498,Zion Williamson\willizi01,PF,19,NOP,12,12,337,106,181,.586,5,12,.417,101,169,.598,.599,57,94,.606,42,44,86,27,8,5,29,19,274
499,D.J. Wilson\wilsodj01,PF,23,MIL,28,0,243,34,84,.405,11,46,.239,23,38,.605,.470,5,7,.714,7,48,55,18,1,5,14,22,84
500,Justise Winslow\winslju01,SF,23,MIA,11,5,352,50,129,.388,6,27,.222,44,102,.431,.411,18,27,.667,16,57,73,44,7,5,24,38,124
501,Christian Wood\woodch01,PF,24,DET,55,5,1071,221,393,.562,43,113,.381,178,280,.636,.617,153,204,.750,82,242,324,45,25,48,65,82,638
502,Delon Wright\wrighde01,SG,27,DAL,55,4,1169,153,324,.472,36,96,.375,117,228,.513,.528,62,80,.775,59,153,212,185,58,19,53,70,404
503,Justin Wright-Foreman\wrighju02,PG,22,UTA,1,0,2,0,0,,0,0,,0,0,,,0,0,,0,0,0,0,0,0,0,0,0
504,Thaddeus Young\youngth01,PF,31,CHI,57,13,1393,237,528,.449,70,192,.365,167,336,.497,.515,36,61,.590,82,196,278,97,75,20,93,118,580
505,Trae Young\youngtr01,PG,21,ATL,52,52,1840,481,1081,.445,184,492,.374,297,589,.504,.530,412,482,.855,29,199,228,477,60,6,255,89,1558
506,Cody Zeller\zelleco01,C,27,CHO,52,33,1200,228,440,.518,17,71,.239,211,369,.572,.538,105,152,.691,144,228,372,75,35,24,65,130,578
507,Ante Žižić\zizican01,C,23,CLE,17,0,168,31,52,.596,0,0,,31,52,.596,.596,14,16,.875,14,41,55,3,7,4,7,20,76
508,Ivica Zubac\zubaciv01,C,22,LAC,56,54,1000,180,302,.596,0,2,.000,180,300,.600,.596,90,122,.738,147,254,401,60,11,56,48,132,450
